a	un
aardvark	oryctérope
aardvark	adverbe
aardvarks	tamanoirs
aback	à l'arrière
abacterial	non-bactérien
abacus	abaque,boulier
abacus	abaque
abacus	boulier,compteur
abacuses	abaques, bouliers
abacuses	abaques
abacuses	bouliers, compteurs
abaft	en l'arrière, vers l'arrière
abalone	ormeau
abalones	ormeaux
abandon	abandon, laisser-aller
abandon	abandonner
abandoned	abandonné
abandoned	abandonnes
abandoned	dévergondé
abandonee	abandoned, forsaken
abandoner	abandoneur
abandoning	abandonnant
abandonment	abandon
abandonment	abandonnement
abandonments	abandons
abandons	abandonnes
abase	abaisser, humilier
abased	humilié
abasement	abaissement, humiliation
abasements	abaissement
abases	mortifie, humilie, rabaisse
abash	confondre, déconcerter
abashed	confus, embarrasse
abashed	deconcerte, confus, gene
abasing	humiliant
abate	diminuer
abate	s'apaiser, se calmer
abated	a diminué
abatement	diminution
abatement	la suppression
abatements	coupures
abates	se calme, s'apaise
abating	faiblant
abating	faiblant
abattoir	abattoir
abbe	abbé
abberations	aberrations
abbey	abbaye
abbey	une abbaye
abbeys	abbayes
abbot	abbe
abbot	abbé
abbot	abbé
abbot	pere superieur
abbot	abbé
abbots	abbés
abbreviate	abbréger
abbreviate	abréger
abbreviated	abbrégé
abbreviates	s'abrège
abbreviating	abrégeant
abbreviation	abbréviation
abbreviation	abréviation
abbreviation	abreviation
abbreviations	abbréviations
abbreviations	abréviations
abbreviator	abréviateur
abdicable	abdiquable
abdicate	abdiquer
abdicate	renoncer
abdicated	abdiqué
abdication	abdication
abdicator	abdicateur
abdomen	abdomen
abdomen	abdomen
abdomens	abdomens
abdominal	abdominal
abdominally	abdominalement
abduct	enlever
abducted	enlevé
abducting	enlevant
abduction	enlèvement
abductions	enlèvements
abductor	adducteur
abductors	adducteur
abducts	detourner
abeam	par le travers
abecedarian	abécédaire
abed	au lit
aberrance	aberration
aberrant	aberrant, egare
aberrantly	de façon aberrante
aberration	aberration
aberration	anomalie
aberrations	erreurs
abet	encourager
abetment	encouragement
abets	secourirs
abetted	encouragea, soutient
abetter	complice
abetting	provoquant
abettor	aide, complice
abeyance	en suspens
abeyant	en attente
abhor	avoir horreur de
abhorred	avoué
abhorrence	aversion extreme, horreur
abhorrent	odieux
abhorrently	de façon odieuse
abhorring	abhorrant
abhors	abhorrer
abide	respecter
abided	souffri
abides	tolère, demeure, subsiste
abiding	constant, éternel
abilities	talents
ability	compétence
ability	competence; capacite;
abiotic	abiotique
abject	abject;
abjection	abjection
abjectly	avec servilité
abjuration	renoncement
abjure	abjurer
abjurer	personne qui abjure
ablation	ablation
ablative	ablatif
ablaze	en feu
ablaze	en feu, en flammes
able	compétent
able	capable
abler	plus compétent
ablest	le plus compétent
abloom	en fleur
ablution	ablution
ablutions	ablutions
ably	de façon compétente, habilement
abnegate	Renouncer à
abnegates	renie, répudie, rejette
abnegation	abnégation
abnormal	abnormal
abnormal	anormal
abnormal	anormal
abnormalities	anomalies, difformités
abnormality	anomalie, malformation
abnormally	anormalement
aboard	à bord
abode	of no fixed ~ :sans domicile fixe
abodes	demeures, domiciles
aboil	en train de bouillir
abolish	abolir
abolish	abroger, supprimer
abolishable	qui peut être aboli
abolished	aboli
abolisher	suppresseur
abolishes	abolit, abroge, supprime
abolishment	suppression, abolition, abrogation
abolition	abolition
abolition	suppression
abolitionism	abolitionnisme
abolitionist	abolitionniste
abolitionists	abolitionnistes
abominable	abominable
abominably	abominablement, odieusement
abominate	abhorrer, exécrer, abominer
abomination	abomination
abominations	abominations
aboriginal	aborigène
aboriginally	aboriginalement
aborigine	aborigene m/f
aborigines	aborigines
abort	faire avorter
aborted	avorté
aborter	avorteur/ avorteuse / faiseuse d'anges
aborting	discontinuant
abortion	avortement
abortion	avortement
abortionist	avorteur
abortionists	avorteurs
abortions	avortements
abortive	manque
abortively	en vain
aborts	avorte, échoue, abandonne
abound	abonder
abounding	abondant
about	environ, a peu pres
above	au-dessus
aboveboard	régulier, correct
aboveground	au-dessus du sol, à la surface
abovementioned	ci-haut mentionné
abovementioned	mentionné ci-dessus
abracadabra	abracadabra
abradable	qui peut s'érafler, qui peut s'éroder
abrade	user en frottant, éroder
abrasion	frottement, écorchure, abrasion
abrasions	écorchures, égratignures
abrasive	abrasif
abrasives	abrasifs
abreast	de front
abridge	abreger
abridged	abrégé
abridgement	résumé
abridging	raccourçant
abroad	à l'étranger, au loin
abrogate	abroger
abrogated	abrogé, aboli
abrogation	abrogation
abrupt	abrupte
abruptly	brusquement
abruptness	abrupte
abscess	abcès
abscesses	abcès
abscond	s'enfuir
absconded	s'enfuir
absence	absence
absences	absences
absent	absent
absentee	absentee
absenteeism	absentéisme
absentees	absentees
absently	distraitement
absentminded	distrait
absentmindedly	d'un air distrait
absentmindedly	distraitement
absentmindedness	distraction
absinth	absinthe
absinthe	absinthe
absolute	absolu
absolutely	absolument
absolution	absolution
absolutism	absolutisme
absolve	absoudre
absolved	exonéré
absolving	exonérant
absorb	absorber, retenir, assimiler
absorbability	absorbabilité
absorbable	absorbable
absorbant	absorbant
absorbed	absorbé
absorbent	absorbant
absorbing	absorbant
absorption	absorbtion
abstain	abstenir
abstained	absteni
abstemious	frugal, sobre
abstention	abstention
abstentions	abstentions
abstinence	abstinence
abstinent	sobre
abstinently	sobrement
abstract	abstrait
abstract	résumé, abrégé
abstraction	distraction, abstraction
abstruse	abstrus
absurd	absurde
absurdism	absurdisme
absurdist	absurdiste
absurdities	absurdités
absurdity	absurdité
abundance	abondance
abundant	abondant
abundantly	abondamment
abuse	abus
abused	abusé
abused	insulter
abusive	abusif
abusively	abusivement
abut	etre contigu
abuzz	bourdonnant
abysmal	épouvantable, abominable
abysmally	abominablement
abyss	abysse
abyss	abîme
abysses	abysses
abysses	abîmes
acacia	acacia
academic	académique
academical	académique
academically	académiquement
academician	académicien
academies	academies
academism	academisme
academy	académie
acanthus	acanthe
acanthuses	acanthes
accede	accéder
accede	consentir
accelerate	accélérer
accelerated	accéléré
acceleration	accélération
accelerations	accélérations
accelerator	accélérateur
accelerators	accélérateurs
accelerometer	accéléromètre
accelerometers	accéléromètres
accent	accent
accented	accenté
accented	accentué
accents	accents
accentual	accentuelle
accentually	accentuellement
accentuate	accentuer
accentuated	accentué
accentuation	accentuation
accept	accepter
acceptability	acceptabilité
acceptable	acceptable
acceptably	convenablement
acceptance	acceptation
accepted	accepté
accepter	accepteur
acceptor	accepteur
access	accès
accessed	accessé
accessibility	accessibilité
accessible	accessible
accession	accession
accessorial	accessoire
accessories	accessoires
accessorize	accessoriser
accessors	accesseurs
accessory	accessoire
accident	accident
accidental	accidentel
accidentalism	accidentalisme
accidentalist	accidentaliste
accidentally	accidentellement
accidently	accidentalement
accidents	accidents
acclaim	acclamer
acclamation	acclamation
acclimate	acclimater
acclimated	acclimaté
acclimatize	acclimater
accolade	accolade
accolades	accolades
accommodate	accomoder
accommodated	accommodé
accommodating	obligeant
accommodation	accomodation
accommodations	accommodations
accompanied	accompagné
accompanier	accompagneur
accompanies	accompanies
accompaniment	accompagnement
accompaniments	accompagnements
accompanist	accompaniste
accompanists	accompanistes
accompany	accompagner
accompanyist	accompagnateur
accompanyists	accompagnateurs
accomplice	complice
accomplices	complices
accomplish	accomplir
accomplished	accompli
accomplishment	accomplissement
accomplishments	accomplissements
accord	accord
accordance	conformité
accorder	accordeur
accorders	accordeurs
accordion	accordéon
accordionist	accordionist     accordioniste
accordionists	accordionists     accordionistes
accordions	accordéons
accords	accords
accost	accoster
account	compte
accountability	responsibilité
accountable	responsable
accountant	comptable
accounting	comptabilité
accouterment	accoutrement
accredited	accredité
accrued	accrué
accruement	accruement
accumulated	accumulé
acetaminophen	acétaminophèn
acetify	acetifié
acetone	acetone
acid	acide
acidic	acidique
admission	aveu
allergen	allergene
allergen	allergene
allergic	alergique
allergies	allergies
allergies	allergies
allergy	allergie
allergy	allergie
alleviate	apaiser, soulager
alleviated	apaisé, apaisée
alley	ruelle, allée
alley	ruelle, allée
alleys	ruelles, allées
alleys	ruelles, allées
alliance	alliance
alliance	alliance
alliances	alliances
alliances	alliances
allied	allié, alliée
allied	allié, alliée
alligator	alligator
alligator	alligator
alligators	alligators
alligators	alligators
alliteration	allitération
alliteration	allitération
alliterations	allitérations
alliterations	allitérations
allocate	attribuer
allocated	attibué, attribuée
allocation	attribution
allocation	attribution
allocations	attibutions
allocations	attributions
allocution	allocution
allocution	attribution
allocution	allocution
allot	assigner
allow	autoriser, permettre
allowable	admissible
allowance	indemnité
allowed	autorisé, autorisée
alloy	alliage
alphabet	alphabet
alphabetic	alphabetique
alphabetical	alphabetique
alphabetically	alphabetiquement
alphabetization	alphabetisation
alphabetizations	alphabetisations
alphabetize	alphabetiser
alphabetized	alphabetise
alphabetizing	alphabetizer
alphabets	alphabets
alphamerical	alphanumerique
alphanumeric	alphanumerique
alphanumerical	alphanumerique
alphanumerically	alphanumeriquement
alphanumerics	alphanumerique
alpine	alpin
alpinism	alpinisme
alpinist	alpiniste
already	deja
also	aussi
altercation	altercation
altercations	altercations
alternate	alterner
alternated	alterne
alternately	alternativement
among	parmi, entre
amoral	amoral
amorous	amoureux
amorously	amoureusement, avec amour
amorphous	amorphe
amount	s'elever. monter
amount	somme, quantite, importance
amp	ampere ; amplifier
ampere	ampere
ampersand	et commercial ; esperluette
amphetamine	amphetamine
and	et
anyway	En tout cas, de toute facon
anywhere	n'importe ou ; partout
aorta	aorte
apace	rapidement
apart	a part, separe
apartheid	apartheid
apartment	apartement, chambre
apathetic	apathique
apathy	apathie, indifference
ape	singe
ape	singer
aperitif	aperitif
aperture	ouverture
apex	sommet
aphid	aphis; puceron
arrive	arrivant
aspen	abedul
audit	audit
auditorium	auditorium
auditoriums	auditoriums
audits	audits
available	disponible
babble	bavard
babbler	bavardent
babies	bébés
baboon	babouin
baby	bébé
baccalaureate	baccalauréat
baccarat	baccarat
bachelor	célibataire
bachelors	célébataires
bacilli	bacilles
bacillus	bacille
back	en arriere, en retour
backache	douler de dos
backbite	calumnier
backbone	épine
background	arriere-plan
backgrounds	arriere-plans
backside	derrière
backslide	régresser
backup	sauvegarde
backward	en arrière
bacon	lard
bacteria	bactérie
bad	mauvais, torve
badge	insigne
badged	insignée
badgers	blaireaux
badinage	badinage
bag	sac
bagatelle	bagatelle
bagatelles	bagatelles
baggage	effets, colis
bags	fouilles, étuis, sacs
baguette	baguette
bah	bannir
bail	caution
bairn	enfant
bait	leurre, eche
bake	faire cuire
baker	boulanger
bakeries	boulangeries
bakers	boulangers
bakery	boulangerie
bakeshop	boulangerie
balance	balance, équilibrer
balconies	balcons
balcony	balcon
bald	chauve, à ras
baldhead	chauve
baldly	ouvertement
baldness	calvitie
bale	ballot
baleen	baleine
balk	déjouer
ball	ballon
ballad	ballade
ballade	ballade
ballads	ballades
ballast	ballast, lest
ballet	ballet
balletic	balletique
balloon	ballon, aérostat
ballot	ballot
balls	bals
ballyhoo	publicité
balm	baume
bamboo	bambou
bamboozle	tricher
banana	banane
bananas	bananes
band	bande, chapelle
bandage	bandage
bandeau	bandeau
bandit	brigand, forban, bandit
bandits	brigands, forbans, bandits
bandleader	chef d'orchestre
bandmaster	chef d'orchestre
bane	poison
banished	banni
barb	barbe
barbarian	barbare
barbarians	barbares
barbarism	barbarisme
barber	barbier
barmaid	serveuse
barman	serveur
barracks	casernes
beach	plage
bear	ours
bear	supporter
bed	lit
bedroom	chambre
believe	croire
betray	trahir
bibliographic	bibliographique
bibliographies	bibliographies
bibliography	bibliographie
blackberry	zarzamorra
bonjour	hello
book	livre
boomerang	boomerang
boxer	caleçon
boy	garçon
boys	garçons
brain	cerveaux
brood	rimuginare, covare
broom	balai
broth	bouillon
build	construire
building	bâtiment
bye	bon voyage, ciao
cab	taxi
cabal	cabale
cabala	cabale
cabalism	cabalisme
cabalist	cabaliste
cabalistic	cabalistique
caballero	cavalier
cabaret	cabaret
cabbage	chou
cabbages	choux
cabdriver	chauffeur de taxi
cabin	cabane
cabinet	cabinet
cabinetmaker	ébéniste
cabinetmakers	ébénistes
cabinets	cabinets
cabins	cabines
cable	câble
cabled	cablé
cablegram	câblogramme
cablegrams	câblogrammes
cables	câbles
cabling	cablage
cabman	cocher de fiacre
caboose	caboose
cabotage	cabotage
cabriolet	cabriolet
cabs	taxis
cacao	cacao
cacciatore	chasseur
cachalot	cachalot
cache	cachette
cachepot	cachepot
caches	cachettes
cackle	caquet
cackled	caqueté
cackles	caquets
cackling	caquetant
cacophony	cacophonie
cacti	cactus
cactus	cactus 
cad	mufle
cadaver	cadavre
cadaverous	terreux,
caddies	boîtes à thé
caddy	boiîte à thé
cadence	cadence
cadet	cadet, younger son
cadetship	brevet de cadet
cadge	mendier
cadger	mendiant
cafe	café-restaurant
cafes	café-restaurants
cafeteria	cafétaria
cafeterias	cafétarias
caffeine	caféine
caftan	caftan
cage	cage
cages	cages
cahier	copy book
cairn	cairn
cairns	cairns
caitiff	lâche
cajole	cajoler
cajoler	cajoleur
cajolery	cajolerie
cake	gâteau
cake	gâteau
calcium	calcium
calculate	calculer
calculated	calculé
calibrate	calibrer
calibrated	calibré
calibration	calibration
car	voiture
carbonization	carbonisation
carbonize	carboniser
carbonized	carbonise
carbonless	sans carbone
carburetor	carburateur
carburetors	carburateurs
carburization	carburation
carburize	carburer
card	carte
cardamom	cardamone
cardiac	cardiaque
cardigan	cardigan
cardioid	cardioide
cardioids	cardioides
care	attention
care	care
cared	attentionne
career	cariere
careful	attentionne
carefully	avec attention
cat	le chat
cell	cellule
cellular	cellulaire
chance	hasard
cherries	les cerises
church	église
churches	églises
cloak	manteau
cloaks	manteaux
clock	horloge
clockmaker	horloger
clockwise	dans le sens des aigüilles d'une montre
cloister	cloitre
clone	clone
cloud	le nuage
c'mon	ben voyons
coal	charbon
computer	ordinateur
computers	ordinateurs
comrades	amis
concealed	étouffé
conjuring	escamotage
contemplate	contempler
contemplate	envisager
contemplate	prévoir
contemplates	envisage
contemplation	contemplation
contemplation	méditation
contemplation	recueillement
contemplations	contemplations
contemplations	méditations
contemplative	contemplatif
contemporaneous	contemporain
contemporaneously	en même temps que 
contemporaries	contemporains
contemporaries	de la même génération
contemporary	contemporain
contemporary	de la même génération
contempt	dédain
contempt	mépris
contemptible	indigne
contemptible	méprisable
contemptibly	avec mépris
contemptuous	de mépris
contemptuous	méprisant
contemptuously	avec dédain
contemptuously	avec mépris
contend	combattre
contend	disputer
contend	lutter
contender	candidat
contender	challenger
contender	concurrent
contenders	candidats
contenders	challengers
contenders	concurrents
contending	concurrents
contending	opposées
contends	dispute
contends	lutte
content	contenter
content	satisfaire
content	satisfait
contented	content
contented	satisfait
contentedly	avec contentement
contentedness	contentement
contention	dispute
contention	émulation
contention	lutte
contentions	disputes
contentions	émulations
contentions	luttes
contentious	contentieux
contentious	querelleur
contentment	contentement
contents	contenu
contents	table de matières
contest	combat
contest	concours
contest	contester
contestant	combattant
contestant	concurrent
cot	lit d'enfant
coterie	coterie
cotillion	cotillon
cotillon	cotillon
cottage	chaumière
cottager	paysan
couch	couche
cough	tousser
coughs	toux
count	compter
countenance	visage
counteract	neutraliser
counterbalance	contrepoids
counterfeit	contrefait
countermand	contremander
countermarch	contremarche
counterplot	contre-ruse
counterpoint	contrepoint
counterpoise	contre-balancer
counterweight	contrepoids
countess	comtesse
countless	innombrable
country	pays
countryman	concitoyen
countrywide	concitoyenne
county	comté
couple	couple
couplet	distique
coupon	coupon
courage	courage
courageous	courageux
courageously	cougrageusement
courier	courrier
course	cours
courser	coursier
court	cour
courteous	courtois
courteously	courtoisement
courteousness	courtoisie
courtesy	courtoisie
courthouse	palais de justice
courtier	courtisan
courtliness	élégance
courtly	élégant
courtmartial	conseil de guerre
courtroom	salle d'audience
courtship	cour
cousin	cousin
cove	anse
covenant	convention
cover	couvrir
covert	caché
covet	covoiter
covetous	avide
covetously	avidement
cow	la moo cowetta
cow	la vache
coward	lâche
cowardice	lâcheté
cowardly	lâche
cower	se blottir
cowherd	vacher
cowl	capuchon
coxcomb	petit-maître
coy	farouche
coyly	modestement
coyness	réserve
coyote	coyote
cozily	confortablement
cozy	confortable
crab	cancre
crabapple	pomme sauvage
crabbed	maussade
crack	fente
cracker	pétard
crackle	craqueter
cradle	berceau
craft	fourberie
craftily	astucieusement
crag	rocher escarpé
cram	fourrer
cramp	crampe
cranberry	airelle coussinette
crane	grue
cranium	crâne
crank	manivelle
crankiness	humeur difficile
cranky	d'humeur difficile
crape	crêpe
crash	retentir
crate	caisse à claire-voie
crater	cratère
crave	désirer ardemment
craven	poltron
crawl	ramper
crayfish	écrevisse
crayon	pastel
craze	manie
crazily	follement
crazy	fou
creak	grincer
cream	crème
creamy	crémeux
crease	plisser
create	créer
creation	création
creator	créateur
creature	créature
credence	croyance
credential	certificat
credit	crédit
creditable	estimable
creditably	honourablement
creditor	créancier
credo	crois
credulity	crédulité
credulous	crédule
credulously	crédulement
creed	credo
creek	crique
creep	ramper
creeps	chair de poule
cremate	incinérer
cut	couper
cute	mignon, charmant, adorable
cute	mignonne
cuteness	gentillesse, charme
cutoffs	limite, seuil
cutout	forme à découper
cuts	économies, réduction de budget
cutter	couteau
cutting	découpe, découpage
cyanate	cyanante
cyanide	cyanure
cybernetic	cybernétique
cybernetician	cybernéticien
cybernetics	cybernétique
cycle	cycle
cyclic	cyclique
cyclical	cyclique
cyclist	cycliste
cyclists	cyclistes
cycloid	cycloïde
cycloidal	cycloïdal
cyclone	cyclone
cyclonic	cyclonique
cyclopean	cyclopéen
cyclotron	cyclotron
cylinder	cylindre
dad	papa
daddies	papas
daddy	papa
dads	papas
daffy	barjot
daft	barje
dagger	dague
dahlia	dahlia
dahlias	dahlias
daily	quotidien
daintier	plus délicat
dainty	délicat
dairy	laitier
dalmatian	dalmatien
dalmatians	dalmatiens
dam	barrage
damage	abimer
damage	dégât
damage	endommagement
damage	endommager
damaged	endommagé
damaged	endommagé
damager	endommageur
damagers	endommageurs
damages	dégâts
damaging	endommageant
dame	dame
dammit	merde alors
damnation	damnation
damned	damné
damp	humide
dampen	humidifier
dampened	humidifié
dampness	humidité
dams	barrages
dance	danse
dancer	danceur
dancers	danceurs
dancing	danser
dandelion	pissenlit
dandelions	pissenlits
dandies	dandys
dandruff	pelicule
danger	danger
dangerous	dangereux
d'art	d'art
day	jour
daybreak	aube
daylight	lumiere du jour
days	jours
deactivate	désactiver
deactivation	désactivation
dead	mort
deaf	sourd
deaths	morts
deep	profond
density	densité
deserve	meriter
d'etat	d'état
d'etre	d'être
device	périphérique
device	périphérique
dictated	dicté
dictates	dicte
dictation	dictée
dictations	dictées
dictionaries	dictionnaires
dictionary	dictionnaire
did	a fait
die	mourir
died	mort
diesel	diesel
diet	diète
dietetically	diététiquement
diets	diètes
different	différent
difficulties	difficultés
difficulty	difficulté
dig	creuser
digested	digéré
dignitaries	dignitaires
dignities	dignités
dignity	dignité
dilate	dilater
dilated	dilaté
doctor	docteur
document	document
d'oeuvre	d'oeuvre
dog	chien/ne
doggie	chien/ne
dogs	chiens
drink	boire
drinks	boissons
drive	conduire
driver	conducteur
drizzle	bruiner
dry	sécher
duck	canard
each	chaque
eagle	aigle
eagles	aigles
eaglet	aiglon
ear	oreille
earache	mal d'oreille
eardrum	tympan
eardrums	tympans
earlobe	lobe d'oreille
early	tôt
earn	gagner
earning	gagner
earphones	écouteurs
earring	boucle d'oreille
earrings	boucles d'oreille
ears	oreilles
earth	terre
earthquake	tremblement de terre
earthquakes	tremblements de terre
earths	terres
earthworm	ver de terre
earthworms	vers de terre
earwax	serumen
ease	facilité
easel	chevalet
easier	plus facile
easiest	le plus facile
easily	facilement
easiness	facilité
east	est
easter	Pâques
easy	facile
eat	manger
eatable	comestible
eats	manger
ebony	ébène
eccentric	excentrique
eccentricity	excentricité
ecclesiastic	ecclésiastique
echo	écho
eclipse	éclipse
ecologic	écologique
ecologist	écologiste
ecology	écologie
economics	econom'ica
ecru	écru
eight	huit
eighteen	dix-huit
eighteenth	dix-huitième
eightfold	huit fois
eighth	huitième
eighties	les années quatre-vingt
eightieth	quatre-vingtième
eighty	quatre-vingt
eightyfold	quatre-vingt fois
einsteinium	einsteinium
either	soit
ejaculate	éjaculer
ejaculated	éjaculé
ejaculates	éjacule
ejaculating	éjaculant
ejaculation	éjaculation
ejaculations	éjaculations
ejaculatory	éjaculatoire
eject	éjecter
ejectable	éjectable
ejecting	éjectant
ejection	éjection
ejector	éjecteur
ejectors	éjecteurs
elaborate	élaborer
elaborated	élaboré, élaborée
elaborates	élabore
elaborating	élaborant
elaboration	élaboration
elaborations	élaborations
elevator	ascenseur
eleven	onze
eleventh	onzième
eliminate	éliminer
end	fin
environment	ambiente
environmental	ambiental
envoy	enviado
envy	envidia
envy	envidiar
escalator	escalier roulant
establish	constater
event	occasion
eventual	final
eventually	finallement
ever	toujours
evergreen	permanent
everlasting	permanent
every	chaque
everywhere	partout
eviction	mise a` l' e'cart
evidence	preuve
exclaim	s'exclaimer
fable	fable
fables	fables
fabric	tissu
fabricant	fabricant
fabricate	fabriquer
fabricated	fabriqué
fabricates	fabrique
fabricating	fabriquant
fabrication	fabrication
fabrications	fabrications
fabricator	fabricant
fabricators	fabricants
fabrics	tissus
fabulist	fabuliste
fabulous	fabuleux
facade	façade
facades	façades
face	visage
faceless	sans face
faceplate	face avant,panneau avant
facet	facette
facetious	facétieux
facetious	plaisant
facetiously	facétieusement
facial	facial
facies	faciès
facile	facile
facilitate	faciliter
facilitated	facilité
facilitates	facilite
facilitating	facilitant
facilities	instalations
facility	usine, établissement
facing	face a, en face de
facsimile	facsimilé
fact	fait
faction	faction
factor	facteur
factorial	factoriel
factorials	factorielles
factories	usines
factorization	factorisation
factorizations	factorisations
factorize	factoriser
factorized	factorisé
factors	facteurs
factory	usine
facts	faits
factual	factuel,factuelle
facultative	facultatif
facultatively	facultativement
faculties	facultés
faculty	faculté
fad	affaiblir, atténuer
fade	se faner
faded	affaibli, atténué
fader	atténuateur
faders	atténuateurs
fading	affaiblissement, atténuation
faery	fée
faience	faïence
fail	échouer
faint	s'évanouir
faintly	faiblement
fair	juste
fairly	équitablement
fairy	fée
faith	foi
faithful	fidèle
faithfully	fidèlement
fashion	mode
fashionable	à la mode
fast	rapide
fasten	attacher
fastener	fermeture
fastidious	exigeant
fat	gros
fatal	mortel
fatalism	fatalisme
fatality	victime
fatally	mortellement
fate	destin
fish	poisson
fishable	pêchable
fishbowl	bôl à poisson
fished	pêché
fisher	pêcheur
fisheries	poissonneries
fisherman	pêcheur
fishermen	pêcheurs
fishers	pêcheurs
fishery	poissonnerie
fishes	poissons
fishing	à la pêche
fishtail	queue de poisson
fission	fision
fissionable	fisionable
fissure	fissure
fist	poing
fisted	poingé
fistful	poingée
five	cinq
fivefold	cinq fois
fix	réparer
fixation	fixation
fixations	fixations
fixity	fixité
fixture	support
fixtures	supports
fjord	fjord
fjords	fjords
flight	le vol
floppy	disquette
fluently	couramment
foot	pied
football	football
forget	oublier
forgetful	oublieux
forgetfulness	manque de mémoire
forgivable	excusable
forgivably	de façon excusable
forgive	pardonner
forgiveness	pardon
forgives	pardonne
forgiving	indulgent
forgo	renoncer
forgoes	renonce
forgotten	oublié
forlorn	délaissé
formaldehyde	formaldéhyde
four	quatre
fox	renard
fractal	fractale
fractals	fractales
fraction	fraction
fractionate	fractionner
fraternal	fraternel
fraternize	fraterniser
friend	ami
friendship	Amitie
fringe	frange
frog	grenouille
frogs	grenouilles
from	de
front	devant
fucked	foutu
fudge	sucre a` la cre`me
fugue	fugue
fulgurant	fulgurant
funk	frouse
funniest	le plus amusant
funny	amusant
gab	bavarde
gabardine	gabardine
gabber	commère
gabbing	bavarder
gaberdine	une gabardine
gadget	un gadget
gaiety	la gaieté
gaily	gaiement
gain	le gain
gained	gagné
gaining	gagnant
gala	un gala
galactic	galactique
galaxies	galaxies
galaxy	une galaxie
gallant	gallant
gallantly	gallamment
gallantry	la gallantrie
galleries	galleries
gallery	gallerie
gallon	un gallon
gallop	galloper
galloped	gallopé
galloping	gallopant
galvanic	galvanique
galvanism	le galvanisme
galvanize	galvaniser
galvanized	galvanisé
game	un jeu
games	joues
garlic	ail
gas	essence
gasoline	essence
ghostwriter	négre
gift	cadeau
gifts	cadeaux
go	aller
goal	objectif
goals	buts
goat	oie
god	dieu
goddess	déesse
goddesses	déesses
godfather	parrain
golf	golf
golfer	geolfeur
golfers	golfeurs
golfs	golfs
good	bon;bien
good	bien
goodbye	au revoir
goodnight	bon nuit
gopher	gopher
gospel	evangile
gown	la robe
grab	saisir
gradient	pente
gradually	graduellement
grammar	grammaire
grape	le raisin
grapefruit	le pamplemousse
habilitated	habilité
habilitation	habilitation
habit	coutume
habitant	habitant
habitants	habitants
habitat	habitat
habitation	demeure
habitual	usuel
had	se faire avoir
hand	main
head	tete
heats	series
heaven	paradis
heavy	lourd
hectare	hectare
hectares	hectares
hectoliter	hectolitre
hedge	haie
hedgehog	hérisson
heed	suivre
heel	talon
heeler	guerisseur
heels	talons
height	hauteur
heir	héritier
held	tenu
helices	helices
hell	enfer
hello	bonjour
helm	barre
helmet	casque
help	aide
hemp	chanvre
hen	poule
herd	troupeau
here	içi
heron	huron
hips	flancs
hit	frapper
hockey	hockey
hogwash	non sense
holidayer	vacancier
holidays	vacances
home	maison
homeless	sans-abri
homes	maisons
house	maison
ice	glace
instancing	instanciation
internship	stage professionnel en entreprise ou ailleurs
jab	planter
jabber	baragouiner
jabberwocky	jabberwocky
jack	criq
jack	valet
jackal	chacal
jackals	chacaux
jackass	âne
jackdaw	choucas
jacket	blouson
jacket	veste
jackhammer	marteau piqueur
jackknife	canif
jackpot	gros lot
jade	jade
jaded	brimée
jag	bombe, noce
jagged	e'bre'che
jail	emprisonner
jail	prison
jailbreak	evasion
jailed	emprisonné
jailer	geôlier
jailing	incarcération
jailor	geôlier
jails	prisons
jalopy	guimbarde
jam	confiture
jam	enfoncer
jamb	jambage
jammed	coincé
jammed	enrayé
jangle	faire retenir
janitor	agent d'entretien
janitor	concierge
jar	bocal
jar	pot
jar	secousse
jargon	jargon
jasmine	jasmin
jaundice	jaunisse
jaunt	balade
jaunty	désinvolte
jaunty	insouciant
javelin	javelot
jaw	mâchoir
jaws	mâchoires
jay	geai
jazz	jazz
jazzy	voyant
jealous	jaloux, jalouse
jealousy	jalousie
jeer	conspuer
jeer	huer
jelly	gelée
jellyfish	meduse
jeopardize	compromettre
jeopardize	mettre en danger
jerk	abruti
jerk	bousculer
jerry	boche
jersey	jersey
jersey	pull
jest	plaisanterie
jester	bouffon
jester	fou
jet	gicleur
jet	réacteur
jettison	jeter, larguer
jetty	jetée
jewel	joyau
jeweler	bijoutier
jewelery	bijouterie
jewelry	bijouterie
jewels	joyaux
jib	foc
jiffy	en un clin d'oeil
jig	gigue
jigsaw	puzzle
jihad	lutte
jilt	laisser tomber
jingle	tinter
jingle	jingle, indicatif
jingle	cliquetis
jinx	poisse
jitters	trac
job	boulot
job	emploi
jobless	au chômage
jockey	jockey
jocular	enjoué, jovial
jocund	gai
jodhpur	jodhpur
jog	faire du jogging
jogging	jogging
join	joindre
join	raccord
joinable	joignable
joined	joint
joiner	menuisier
joinery	menuiserie
joint	articulation
joint	jointure
jointly	conjointement
joke	blague
joke	plaisanterie
joked	plaisanta
joker	joker
jokingly	en plaisantant
jokingly	pour rire
jolly	jovial, enjoué
jolt	secousse
jolt	soubresaut
jonquils	jonquilles
jostle	bousculer
jot	noter
jot	grain, brin
journal	journal
journalism	journalisme
journalist	journaliste
journalists	journalistes
journey	periple
journey	voyage
jovial	jovial
jovially	jovialement
joy	joie
joyful	joyeux
joyfully	joyeusement
joyless	sans joie
joyously	joyeusement
jubilant	débordant de joie
jubilee	jubilé
judge	juge
judge	juger
judged	jugé
judgement	jugement
judicial	judiciaire
judiciary	magistrature
judo	judo
jug	broc
jug	pichet
jug	pot
juggernaut	poids lourd
juggle	jongler
juggler	jongleur, jongleusse
jugular	jugulaire
juice	jus
juiceless	sans jus
juicier	plus juteux
juiciest	le plus juteux
juicy	juteux, juteuse
jukebox	juke-box
jumble	mélange
jumbo	géant
jump	sauter
jumped	sauta
jumper	robe chasuble
jumpy	nerveux
junction	embranchement
junction	jonction
jungle	jungle
junior	junior
juniper	genièvre
junk	bric-à-brac
junk	camelotte
junk	des ordures
junk	du toc
junkers	casseurs
junkers	chiffonniers
junkie	accro
junkie	drogué
junkyard	une casse
juridic	juridique
jurisdiction	juridiction
jurist	juriste
juror	juré
jurors	jurés
jury	jury
just	juste
justice	justice
justified	justifié
justify	justifier
justly	justement
jut	avancer
juvenile	puéril
juxtapose	juxtaposer
kale	chou
kaleidescope	kaléidoscope
kaleidoscope	kaléidoscope
kangaroo	kangourou
karat	carat
karate	karaté
kayak	kayak
kebab	brochette
keel	la quille
keep	garder
keeps	toujours
keepsake	souvenir
keg	caisson
keg	tonnelet, baril
kennel	niche
kennel	un chenil
kerchief	un foulard
kernel	amande
kernel	noyau
kernel	trognon
kerosene	kérosène
ketchup	ketchup
kettle	une bouilloire
key	légende
key	une clé, or clef
key	une touche
keyboard	un clavier
keyhole	le trou de serrure
keying	taper
keynote	note dominante
keypad	pavé numérique
keypad	un clavier
khaki	kaki
kick	vider
kick	donner un coup de pied
kickback	un retour de manivelle
kicked	frappé du pied
kicker	qui donne des coups de pied
kickoff	le depart synchronisé
kicks	s'amuser
kid	un chevreau, une chevrette
kid	un gosse
kid	un mioche
kiddies	les gamins
kiddies	les gosses
kiddies	les mioches
kidnap	enlever
kidnap	kidnapper
kidnaped	enlevé
kidnaper	enlèvement
kidnaper	un ravisseur
kidnapers	les|des ravisseurs
kidnaping	un enlèvement
kidnapped	enlevé
kidnapper	un ravisseur
kidnappers	les|des ravisseurs
kidnapping	un enlèvement
kidnappings	des enlèvements
kidney	le rein
kidneys	les|des reins
kidneys	les rognons
kids	les|des gamins
kids	les|des gosses
kill	mettre fin à
kill	tuer
killer	meurtrier,meutrière
killer	un tueur
killers	des tueurs
killing	meutre
killing	une tuerie
killings	des tueries
killjoy	rabat-joie
kiln	four
kiln	un fourneau
kilo	kilo
kilobytes	kilo-octet
kilogram	kilogramme
kilohertz	kilo-hertz
kiloliter	un kilolitre
kilometer	un kilomètre
kilowatt	kilowatt
kilt	kilt
kin	aparenté
kind	aimable
kind	doux
kind	gentil
kindergarten	jardin d'enfants
kindergarten	crêche pour enfants
kindergarten	garderie
kindergarten	école maternelle
kindhearted	bon
kindhearted	tendre de coeur
kindheartedness	tendresse de coeur
kindle	susciter
kindle	allumer
kindlessly	froidement
kindlessly	sans coeur
kindliness	douceur
kindliness	gentillesse
kindly	avec douceur
kindly	bienveillant
kindly	doucement
kindly	gentiment
kindness	douceur de coeur
kindness	gentillesse
kindred	aparenté
kindred	semblable, similaire
kinds	des espèces
kinds	des sortes
king	roi
animal kingdom	règne
plant kingdom	règne
kingdom	royaume
kingdoms	royaumes
kingfisher	martin pêcheur
kingly	royal
kings	rois
kinky	vicieux
kiosk	kiosque
kipper	hereng fumé
kiss	baiser
kiss	baiser
kiss	bisou
kiss	embrasser
kisses	baisers
kisses	bisous
kit	trousse
kitchen	cuisine
kitchenette	cuisinette
kitchens	cuisines
kitchenware	batterie de cuisine
kitchenware	ustensiles de cuisine
kite	cerf-volant
kith	parents et amis
kiting	jouer avec un cerf-volant
kitten	chaton
kittens	chatons
kitty	cagnotte
kiwi	kiwi
kleenex	mouchoir en papier
kleptomania	kleptomanie
kleptomaniac	un kleptomane
knack	truc
knapsack	sac-à-dos
knead	pétrir
kneadable	pétrissable
kneader	pétrisseur
knee	le genou
kneecap	la rotule
kneel	mettre à genoux
kneel	s'agenouiller
kneeling	à genoux
kneeling	s'agenouillant
kneepad	protège-genou
knelt	s'agenouilla
knelt	se mis à genoux
knickers	pantalon de golf
knickknack	bibelot
knickknack	babiole
knife	canif
knife	couteau
knifes	des couteaux
knifing	une blessure au couteau
knight	cavalier
knight	chevalier
knighted	être sacré chevalier
knighthood	la chevalerie
knightly	chevalier
knights	des chevaliers
knit	tricoter
knitted	tricotté
knitting	le tricot
knitwear	le tricot
knives	des couteaux
knob	poignée
knob	bouton
knobby	noueux, noueuse
knobs	boutons
knock	frapper
knock	tapoter
knockdown	démolir
knockout	knock-out
knot	noeud
knots	des noeuds
knotted	noué
knotty	épineux
knotty	noueux
know	savoir
knower	celui|celle qui a le savoir
knowhow	le savoir-faire
knowhow	technique
knowing	entendu
knowingly	en connaissance de cause
knowingly	sciemment
knowledge	la connaissance
knowledge	le savoir
knowledgeable	bien informé
known	connu
knows	sait
knuckle	jarret
knuckle	phalange
knucklebone	phalange
knuckles	poing américain
knuckles	les phalanges
koala	koala
kosher	cachère
kosher	kasher
kraut	choucroute
kraut	boche
krauts	les chleus
kudzu	lierre du Japon
lab	labo
labor	travail
laborer	l'ouevrier
laborer	l'ouvrier
laborers	les ouevriers
laborers	les ouvriers
laborious	laborieux, laborieuse
labyrinth	labyrinthe
lace	dentelle
laceration	lacération
lacerations	lacérations
lack	manque
lackadaisical	nonchalant
lackey	laquais
lacking	simplet
lackluster	terne
laconic	laconique
laconically	laconiquement
lacquer	vernis
lacquer	laque
lad	garcon
ladies	Mesdames
lady	dame
ladybird	coccinelle
ladybug	coccinelle
lake	lac
lakes	lacs
lamb	veau
lambs	veaux
laminated	laminé
laminates	lamine
lamp	lampe
language	langue
laugh	rire
leather	cuir
leave	laisser
lectern	lutrin
lecture	conférence
lecturer	conférencier
ledge	rebord
ledger	registre
lee	côté
leg	jambe
legal	legal
legality	legalite
legalize	legaliser
legally	legalement
legate	leguer
legation	legation
legend	legende
legendary	lengendaire
legion	legion
letter	lettre
like	aimer
live	vivre
love	aime
love	amour
lover	amant
luck	chance
lunch	le déjeuner
ma	maman
ma	Mère
ma'am	M'dame
ma'am	madame
ma'am	mademoiselle
macabre	lugubre
macabre	macabre
macabrely	macabrement
macadam	bitume
macadam	macadam
macadamize	goudronner
macadamize	macadamiser
macadamized	goudronné
macadamized	macadamisé
macadamizes	goudronnes
macadamizes	macadamise
macadamizing	goudronnant
macaque	macaque
macaque	macaque
macaroni	macaroni
macaronies	macaronis
macaroon	macaron
macaw	l'ara
mace	sceptre
macerate	mace'rer
macerate	maçérer
macerated	macere'
maceration	mace'ration
macerations	mace'rations
maces	masse
machete	machette
machination	machination
machine	machine
machined	machiné
machineries	machinerie
machinery	machinerie
machines	machines
machinist	machiniste
machinists	machinistes
machismo	machisme
macho	macho
macrocephalic	macroce'phale
macrocosm	macrocosme
macroeconomics	macroeconomie
macroevolution	macroe'volution
macroevolutionary	macroe'volutionnaire
macroinstruction	macroinstruction
macromolecular	macromole'culaire
macromolecule	macromole'cule
macromolecules	macromole'cules
macropathological	macropathologique
macropathology	macropathologie
macrophage	macrophage
macrophages	macrophages
macrophagic	macrophage
macroprocessor	macroprocesseur
macroscopic	macroscopic
macrosimulation	macrosimulation
macrostructure	macrostructure
maculate	maculer
maculated	macule'
maculates	macule
maculation	maculation
maculations	maculations
mad	fache'
mad	fou, folle
madam	madame
madams	mesdames
maddened	rendu fou
made	a fait
made	j'adore
mademoiselle	mademoiselle
mademoiselles	mesdemoiselles
maestro	maestro
mafioso	mafieux
magazine	magazine
magic	magique
magician	magicien
magicians	magiciens
magistral	magistral
magistrally	magistralement
magistrature	magistrature
magma	magma
me	moi
mead	le hydromel
meadow	le pré
meadow	pré
meadowland	les prairies
meadows	prés
meager	maigre
meagerly	maigrement
meagre	maigre
meal	repas
meals	repas
mealtime	heure du repas
mean	moyenne
meander	méandre
meaningless	insensé
meanings	significations
means	moyen
meanwhile	entretemps
measurable	mesurable
meat	viande
meatball	boulette de viande
meatballs	boulettes de viande
mechanical	mécanique
mechanician	mécanicien
mechanism	mécanisme
mechanisms	mécanismes
medal	médaille
medallion	médaillon
medallions	médaillons
mediatrice	médiatrice
mediatrix	médiatrice
medic	médecin
medical	médical
medically	médicalement
medicament	médicament
medicaments	médicaments
medicinal	médicinal
medicine	médecine
medicines	médecines
medico	medico
medicolegal	médicolégal
medics	médecins
medieval	médiéval
medievalist	médiévaliste
medievalists	médiévalistes
mediocre	médiocre
mediocrities	médiocrités
mediocrity	médiocrité
meditate	méditer
meditates	médite
meditation	méditation
meditations	méditations
meditative	méditatif
meditatively	d'un air méditatif
medium	médium
medlar	nèfle
medley	mélange
medleys	mélanges
medulla	médulle
medusae	méduses
meek	doux
meekly	avec soumission
meekness	soumission
meerschaum	pipe en écume de mer
megabyte	méga-octet
megabytes	méga-octets
megacycle	mégacycle
megahertz	mégahertz
megalith	mégalithe
megalithic	mégalitic
megalomania	mégalomanie
megalomaniac	mégalomane
megalomaniacal	mégalomane
megaphone	mégaphone
melancholia	mélancolie
melancholic	mélancolique
melange	mélange
melodic	mélodique
melodies	mélodies
melodious	mélodieux
melodrama	mélodrame
melodramas	mélodrames
melodramatic	mélodramatique
melody	mélodie
melon	melon
melons	melons
melted	fondu
member	membre
members	membres
membrane	membrane
membranes	membranes
membranous	membraneux
memoir	mémoire
memoirs	mémoires
memorable	mémorable
memories	souvenirs
memorize	mémoriser
memorized	mémorisé
memory	mémoire, souvenir
men	hommes
menace	menace
menaced	menacé
menagerie	ménagerie
menageries	ménageries
menhir	menhir
meningitis	méningite
meniscus	ménisque
menopause	ménopause
menstrual	menstruel
menstruation	menstruation
menstruations	menstruations
mental	mental
mentality	mentalité
menthol	menthol
mention	mentionner
menu	menu
meow	miauler
meowing	miauleur
meows	miaule
mephitic	méphitique
mercantile	mercantile
mercantilism	mercantilisme
mercenaries	mercenaires
mercenary	mercenaire
merchant	marchand
merchants	marchands
mercury	mercure
mercy	pitié
meridian	méridien
meridians	méridiens
meridional	méridional
merino	mérino
merit	mérite
meritocracy	méritocratie
merits	mérites
mermaid	sirène
mermaids	sirènes
merry	joyeux
message	message
messages	messages
messiahs	messie
messianic	messianique
moan	gémir
moaned	gémit
moaning	gémissant
moans	gémissements
moat	fossé
moats	fosséa
mob	foule
mock	ridiculiser
mocked	ridiculisé
mockery	moquerie
modal	modal
moon	lune
moonlight	clair de lune
moons	lunes
moose	orignal
naive	naif, naive
naively	naivement
naked	nu
name	prenom
named	nomme
nameless	sans nom
namely	nomement 
namely	nommement
names	prenoms
national	nationalé
nationalism	nationalisme
nationalist	nationaliste
native	habitanté du pays
natural	naturel
naturalize	naturaliser
naturally	naturellement
neap	mortes-eaux
near	proche
nearby	près
nearer	plus proche
neglect	abandonner
neighbor	voisin
neighbors	voisins
network	réseau
networked	réseauté
networks	réseaux
nine	neuf
nineteen	dix-neuf
nineteenth	dix-neuvième
nineties	les années quatre-vingt-dix
ninetieth	quatre-vingt-dixième
ninety	quatre-vingt-dix
ninetyfold	quatre-vingt-dix fois
ninth	neuvième
niobium	niobium
nip	téton
nipple	téton
nipples	tétons
nips	tétons
nirvana	nirvana
nitrate	nitrate
nitrated	nitraté
nitrates	nitrates
nitrating	nitratant
nitration	nitratation
nitrations	nitratations
nitric	nitrique
nitride	nitrate
nitrogen	azote
nitroglycerin	nitroglycérine
nitroglycerine	nitroglycérine
noble	noble
nobleman	noble
noblemen	nobles
nobleness	noblesse
nobody	personne
noctambulism	noctambulisme
noctambulist	noctambule
nocturn	noctune
nocturnally	de nuit
now	maintenant
nowadays	de nos jours, aujourd'hui
noway	pas question, pas du tout
noway	pas question, pas du tout
oaf	nigaud
oafish	stupide
oafishness	sottise
oak	chêne
oar	rame
oarsman	rameur
oasis	oasis
oat	avoine
oath	serment
oatmeal	farine d'avoine
obdurate	invétéré
obedience	obéissance
obedient	soumis
obelisk	obélisque
obese	obèse
obesity	obésité
ocean	ocean
one	un
orange	orange
oranges	oranges
orbit	orbite
orbital	orbital
orbits	orbites
orchestra	orchestre
orchestral	orchestral
orchestras	orchestres
orchestrated	orchestré
order	commande
ordered	ordonné
organism	organisme
organisms	organismes
organist	organiste
organists	organistes
organization	organisation
organizations	organisations
organize	organiser
organized	organisé
organs	organes
orgasm	orgasme
orgasms	orgasmes
orgies	orgies
orgy	orgie
orient	orient
orientable	orientable
oriental	oriental
orientation	orientation
orientations	orientations
oriented	orienté
orients	orients
orifice	orifice
orifices	orifices
orificial	orifique
origin	origine
original	original
originality	originalité
originally	originalement
originals	originaux
origins	origines
ornamental	ornemental
ornithology	ornithologie
orthodox	orthodoxe
orthodoxes	orthodoxes
orthogonal	orthogonal
pace	rhytme
pace	vitesse
pacemaker	stimulateur cardiaque, pacemaker
pachyderm	pachydèrme
pacific	pacifique
pacifically	pacifiquement
pacification	pacification
pacifications	pacificateur / -trice 
pacificist	pacifiste
pacifier	tétine, sucette
pacifism	pacifisme
pacifist	pacifiste
pacify	apaiser
pacify	pacifier
package	paquet;ballot
package	emballage
packaged	emballeE
packaged	paquet
packed	bourré de
packet	paquet;ballot
packing	emballage
pact	pacte, contrat
pacts	pcates, contrats
pad	coussinet, tampon
padding	rembourrage, remplissage
paddle	pagaie, palette
paddock	enclos, paddock
padlock	cadenas
padlock	cadenasser
padrone	patron
paella	paella
pagan	païen
pagans	païens
pageant	spectacle
pageantry	apparat
paid	payé
pail	seau
pain	douleur
pained	peiné
painful	douleureux
painful	pénible
painfully	douloureusement
painstaking	assidu
paint	peindre
paint	peinture
paintbrush	pinceau
painter	peintre
painters	peintre
painting	peinture
paints	couleurs
pair	couple
pajamas	pyjama
pal	copain
pal	copine
palace	palais
palatable	agréable au goût
palaver	palabres
pale	pâle
palette	palette
pall	voile
pallet	palette
pallette	palette
pallor	pâleur
palm	palmier
palm	paume
palpable	évident
palpable	manifeste 
paltry	dérisoire
pamper	choyer, dorloter
pamphlet	brochure
pan	casserole
panacea	panacée
panama	Panama
pancake	crêpe
panda	panda
pandemonium	tohu-bohu
pane	vitre, carreau
panel	invités
paneling	lambris
panelling	lambris
pang	tiraillement
panic	panique
panic	paniquer
panicky	paniqué
panorama	panorama
pansy	pensée
pant	haleter
panther	panthère
panties	culotte
pantry	garde-manger
pants	pantalon
papa	papa
paper	papier
paperback	livre de poche
parameter	paramètre
passer	passeur
passion	passion
passionately	passionnément
passive	passif
passivity	passivité
password	mot de passe
passwords	mots de passe
past	passé
pasta	pâtes alimentaires
peat	tourbe
pectorals	pectoraux
peculiar	important
penitence	pénitence
penitences	pénitences
penitency	pénitence
penitent	pénitent
pentadactyl	pentadactyle
pentadactylism	pentadactylisme
pi	pi
pianist	pianiste
pianistic	pianistique
piano	piano
picture	image
pictures	images
pie	tarte
pies	tartes
pig	cochon
pigeonhole	pigeonnier
pigment	pigment
pigmentation	pigmentation
pigments	pigments
pigs	cochons
pilot	pilote
pilots	pilotes
pilule	pilule
pine	pin
pineapple	ananas
pineapples	ananas
pines	pins
pink	rose
pocket	poche
pocketbook	livre de poche
pocketbooks	livres de poche
pockets	poches
podium	podium
pogrom	pogrom
pogroms	pogroms
pointer	pointeur
pointers	pointeurs
pointillism	pointillisme
pointillist	pointilliste
pointilliste	pointilliste
pointillistic	pointilliste
poison	poison
poisonous	poison
poisonousness	toxicité
poisons	poisons
polar	polaire
polarities	polarités
polarity	polarity
polarize	polariser
polarized	polarisé
polemical	polémique
polemically	de façon polémique
polemically	de manière polémique
polemicize	polémiquer
police	police
policeman	agent de police
policeman	agent
policeman	policier
policemen	agents de police
policemen	agents
policemen	policiers
policewoman	contractuelle
policewomen	contractuelles
policy	politique
polish	polonais
polish	Polonais
polite	poli
politely	poliment
politeness	politesse
political	politique
politically	politiquement
politician	politicien
politicians	politiciens
politics	politique
polka	polka
pollutant	polluant
pollute	polluer
polluted	pollué
polluter	pollueur
pollution	pollution
polonium	polonium
poltergeist	poltergeist
polyandrous	polyandre
polyandry	polyandrie
pour	french
pout	moue
poverty	pauvreté
powder	poudre
powdery	poudreux
power	puissance
powerful	puissant
powerless	impuissant
powwow	assemblée
practicability	possibilité
practicable	réalisable
practical	pratique
pray	prier
prayer	prière
prayers	prières
praying	en prières
praying	prière
preach	prêcher
preach	prononcer
preacher	pasteur
preacher	prédicateur
preachers	pasteurs
preachers	prédicateurs
preaches	prêche
preaches	prononce
preachify	faire la morale
preaching	prédication
preaching	prêcheur
preaching	sermons
preachy	prêcheur
preachy	sermonneur
preamplifier	préamplificateur
preamplifiers	préamplificateurs
prearrange	arranger au préalable
prearrange	arranger d'avance
prince	prince
princedom	principauté
princely	princier
princes	princes
princess	princesse
principal	principal
principal	directeur
principalities	principautés
principality	principauté
principally	principalement
principally	surtout
principals	directeurs
principle	principe
principles	principes
print	empreinte
print	impression
print	marque
printable	imprimable
printed	imprimé
printer	imprimeur
printer	imprimante
priorities	priorité
priorities	priorités
priority	priorité
prove	prouver
pulse	impulsion
pulverizable	pulverisable
pulverizables	pulverisables
pulverization	pulverisation
pulverize	pulveriser
pulverized	pulvérisé
pulverizer	pulverisateur
pulverizers	pulvérisateurs
pulverizes	pulvérises
pulverizing	pulvérisant
puma	puma
pump	pomper
push	pousser
pushchair	chaise roulante
pushing	poussé
put	mettre
putdown	poser
putout	éteindre
putrefaction	putréfaction
quail	caille
quails	cailles
quake	trembler
quality	qualité
qualm	scrupule
qualms	scrupules
quantity	quantité
quarrel	se disputer
quarry	carrière
quarter	quartier
quarterdeck	plage arrière
quarterfinal	quart de finale
queen	reine
queer	bizarre
quell	réprimer
quench	se désaltérer
querulous	ronchonneur
query	question
quest	quête
question	question
queue	queue
quibble	chicaner
quick	rapide
quicklime	chaux vive
quickly	rapidement
quicksand	sables mouvants
quicksilver	vif-argent
quiet	tranquille
quieten	calmer
quietly	doucement
quill	plume d'oie
quilt	édredon
quirk	bizarrerie
quit	se rendre
quite	assez
quota	quota
quotation	citation
quote	citer
r	r
rabbet	feuillure
rabbi	rabbin
rabbinic	rabbinique
rabbit	lapin
rabbits	lapins
rabble	cohue
rabid	enragé
rabies	rage
raccoon	raton-laveur
race	course
racehorse	cheval de course
racemic	recémique
racer	coureur
races	courses
rachis	rachis
rachitic	rachitique
rachitis	rachitisme
racial	racial
racialism	racisme
racialist	raciste
racialistic	raciste
racing	de course
racism	racisme
racist	raciste
rack	étagère
racket	raquette
racket	tumulte
radar	radar
radars	radars
radio	radio
read	lire
readability	lisibilité
readable	lisible
reader	lecteur
readers	lecteurs
readership	lecteurs
readership	lectorat
readily	de bonne grâce
readily	facilement
readily	volontiers
readiness	empressement
readiness	facilité
reading	interprétation
reading	lecture
reading	relevé
readings	interprétations
readings	lectures
readjust	rajuster
readjust	réajuster
readjusts	rajuste
readjusts	réajuste
readout	affichage
readout	d'affichage
readouts	affichages
reads	lit
ready	disposé
ready	prêt
ready	prompt
reaffirm	affirmer de nouveau
reaffirm	réaffirmer
reaffirms	affirme de nouveau
reaffirms	réaffirme
reagent	réactif
real	naturel
real	véritable
real	vrai
realisable	réalisable
realism	réalisme
realist	réaliste
realistic	plein de réalisme
realistic	réaliste
realistically	avec réalisme
reality	réalité
realize	réaliser
really	vraiment
reporter	le reporter
represent	représenter
request	demande
request	exiger
request	requête
road	rue
roads	rues
roadwork	chantier
robber	voleur
room	chambre
rotting	decay
sabbat	un sabbat
sabbath	sabbat
sabbatic	sabatique
sabbatical	sabbatique
saber	sabre
sabin	nom de personne qui a decouvert le vaccine contre poliomyltie
sable	martre
sabot	sabot
sabotage	sabotage
sabotaged	saboté
sabotages	sabotages
saboteur	saboteur
sabra	citoyen du pays Israel, personne ne en Israel
sabras	citoyens du pays Israel, personnese nes en Israel
saccade	une saccade
saccharin	saccharine
saccharine	saccharin
saccharose	saccharose
sacerdotal	appartient a une chose religieuse
sacerdotally	une acte faite en manière sacrée
sachet	un sachet
sack	sac
sack	virer
sackcloth	une vêtement de deuil
sacked	viré
sackful	une mesure "plein d'un sac"
sacks	piller
sacrament	sacrament
sacramental	sacremental
sacraments	sacrements
sacre	sacre
sacred	sacré
sacrifice	sacrifice
sacrificed	sacrifier
sacrifices	sacrifices
sacrilege	sacrilège
sad	malheureux
sad	triste
sadden	attrister
sadder	plus triste
saddest	plus triste
saddle	selle
saddlebag	une sacoche
saddlebags	des sacoches
saddlebow	un arçon
saddlecloth	une housse
saddled	sellé
saddleless	sans selle
saddler	un sellier
saddlery	une sellerie
saddles	 une selle
saddletree	un bois de selle
saddling	sellant
sadism	sadisme
sadist	sadiste
sadistic	sadique
sadistically	sadiquement
sadists	sadistes
sadly	tristement
sadness	tristesse
safari	un voyage, en particulier en Afrique
safe	coffre-fort
safecracker	une personne qui ouvre une caisse illégalement
safecracking	l'acte d'ouvrir une caise illégalement
safeguard	une sauvegarde
safeguarded	sauvegardé
safeguards	garde fous
safer	pplus sauf
safes	les caisses
safest	le plus sauf
safety	le sûreté
safflower	le carthame
saffron	le safran
sag	plier, ployer
saga	une saga
sagacious	prudent
sagaciously	prudemment
sagaciousness	la sagacité
sagacity	la sagacité
sage	le sage
sagely	sagement
sago	le sagou
saguaro	une type de cactus
sahib	une forme d'addresser pour un homme des Indes
said	dit
sail	naviguer
sail	voile
sailable	navigable
sailboat	un bateau  à voiles
sailboater	un marin des bateua à voiles
sailcloth	la toile à voiles
sailor	marin
sailors	les marins
sails	les voiles
sainfoin	le sainfoin
saint	saint
sainted	sacré
sainthood	la sainteté
saints	saints
saith	dit
sake	le vin du riz japonais
salability	vendabilité
salacious	grivois
salad	salade
salads	salades
salamander	salamandre
salami	salami
salaried	salarié
salaries	salaires
sale	solde
saleable	vendable
saleroom	la salle des ventes
sales	les ventes
salesclerk	un vendeur
salesgirl	une vendeuse
saleslady	une vendeuse
salesman	un vendeur
salesmanship	l'art de vendre
salesmen	les vendeurs
salespeople	les vendeurs
salesperson	un vendeur
salesroom	les salles de ventes
saleswoman	une vendeuse
saleswomen	les vendeuses
salient	saillant
saline	salin
salinity	la salinité
salinometer	un salinomère
salinometers	des salinomètres
saliva	salive
salivary	salivaire
salivate	saliver
salivated	 a fait saliver
salivates	fait saliver
salivating	faisant saliver
salivation	;a salivation
sallies	les sorties
sallow	jaunâtre
sallowish	un peu jaunâtre
salmon	saumon
salmons	saumons
salon	salon
salons	salons
salt	sel
saltwater	l'eau de mer
saltworks	la saline
saltwort	le soude
salty	salé
salubrious	salubre
salubrity	la salubrité
salvage	le sauvetage
salver	le plateau
samba	la Samba, une danse originée du Brasil
same	même
sampan	un bateua chinois
samphire	le passe-pierre
samurai	un guerrier ancien japonais
samurais	des guerriers anciens japonais
sand	le sable
sandal	la sandale
school	école
sea	mer
sell	vendre
seller	le vendeur
sellers	les vendeurs
serendipity	le serendiptiy
serene	le serene
seven	sept
sevenfold	sept fois
seventeen	dix-sept
seventeenth	dix-septième
seventh	septième
seventies	les années soixante-dix
seventieth	soixante-dixième
seventy	soixante-dix
seventyfold	soixante-dix fois
sever	blesser
severalfold	plusieurs fois
severe	grave
severed	blessé, blessée
severely	gravement
severities	blessures
severity	gravité
sewage	épandage
sex	sexe
sexagenarian	séxagénaire
shades	lunettes de soleil
shadow	ombre
shadows	ombres
shagreen	chagrin
shah	schah
shake	secouer
shakedown	lit de fortune
shaken	secoué
shaky	tremblant
shaman	chaman
shamanism	chamanisme
shampoo	shampooing
shampoos	shampooings
sheep	agnis
sheepherder	pastor
ship	bâteau
ship	navire
shit	merde
sick	malade
silver	argent
sing	chanter
singer	chanteur
sink	couler
six	six
sixteen	seize
sixteenth	seizième
sixties	les années soixante
sixty	soixante
sixtyfold	soixante fois
size	taille, dimension
skate	patin
skateboard	planche à roulettes
skateboarder	planchiste
skateboarding	faire de la planche à roulettes
skateboards	planches à roulettes
skater	patineur, patineuse
skaters	patineurs, patineuses
skates	patins
skating	patinage
skill	Habileté
skilled	habile
skilless	maladroit
skillful	adroit
skills	talents
sky	ciel
skylark	rossignol
skyscraper	gratte-ciel
snout	groin
snow	neige
snowball	boule de neige
snowflake	flocon de neige
snowman	bonhomme de neige
snowstorm	tempête de neige
software	logiciel
sorrel	oseille
sorrily	tristement
sorrow	tristesse
sort	trier
sorted	trié
sorter	trieur
soul	âme
spectra	spectre
spectrum	spectre
speculate	s'interroger, speculer, conjecturer
speculation	meditation; conjectures ; speculation
staple	agrafe
stapled	agrafé
stapler	agrafeuse
staplers	agrafeuses
staples	agrafes
star	étoile
stars	étoiles
start	départ
stifled	étouffé
strength	force
stupid	Stupide
subject	asignatura
succeed	réussir
success	réussité
sun	soleil
sunbathe	se bronzer
sunny	ensoleillé
suppressed	étouffé
suspect	soupçonner
swear	jurer ; preter serment
tab	happy
tab	sortir
tabernacle	tabernacle
table	table
tableau	tableau
tableaus	tableaux
tableaux	tableaux
tablecloth	nappe
tablecloths	nappes
tables	tables
tablet	comprimé
tablets	comprimés
taboo	tabou
taboos	tabous
tachometer	tachymètre
tachometers	tachymètres
tacit	tacite
tail	queue
tailor	tailleur
tailored	fait sur mesure
tailors	tailleurs
tails	queues
task	tâche
tasks	tâches
taste	goût
tasted	goûté
tasteless	insipide
tear	accroc
tear	déchirer
tear	déchirure
tear	larme
teardrop	larme
tearful	tout en pleurs
tearfully	en pleurant
tearfully	les larmes aux yeux
teargas	gaz lacrymogène
tearjerker	mélo
tearless	avec yeux secs
tearless	sans larmes
tearoom	salon de thé
tears	déchirures
tears	larmes
tearstained	barbouillé de larmes
tearstained	portant des traces de larmes
tease	taquin
tease	taquiner
tease	tourmenter
teasel	cardère
teaser	question dificile
teaser	taquin
teases	excite
teases	taquine
teases	taquins
teasing	railleur
teasing	taquinerie
teasingly	d'un ton railleur
teasingly	pour taquiner
teaspoon	cuillère à café
teaspoon	cuiller à café
teaspoonful	cuillerée à café
teat	bout de sein
teat	mamelon
teat	tette
teat	trayon
teatime	l'heure du thé
teats	mamelons
teats	tettes
ten	dix
tendencies	tendances
tendency	tendance
tenderfoot	visage pâle
tenderly	tendrement
thence	de là
thence	pour cette raison
thenceforth	dès lors
thenceforward	dès lors
theocracy	théocratie
theocratic	théocratique
theodolite	théodolite
theologian	théologien
theologians	théologiens
theological	théologique
theologically	théologiquement
theology	théologie
theorem	théorème
theorems	théorèmes
theoretical	théorétique
theoretical	théorique
theoretically	théoriquement
theoretician	théoricien
theoretician	théoricienne
theoreticians	théoriciennes
theoreticians	théoriciens
theories	théories
theorist	théoricien
theorist	théoricienne
theorists	théoriciennes
theorists	théoriciens
theorize	théoriser
thief	voleur
though	cependant, pourtant
though	quoique , bien que
thought	pensee,idee
thought	reflexion; intention, dessein
thoughtful	pensif, meditatif, reveur
thoughtful	serieux, reflechi, prudent
thoughtfully	pensivement
thoughtfulness	meditation, recueillement
thoughtless	irreflechi, etourdi
thoughtlessly	etourdiment, a la legere, sans reflexion
thoughtlessness	irreflexon, etourderie
thousand	mille, millier
thousandth	millieme
thrash	ecraser qn, rouer qn de coup, 
thrash	se debattre, se demener
thread	fil de soie
threadbare	elime, rape, use
threat	menace
threaten	menacer
threatening	menacant
threateningly	d'un ton menacant
three	trois
tigress	tiger
today	au'jour d'hui
toe	doigt a pied
tradition	tradition
traditional	traditional
trail	piste
train	train
trainee	stagiare
trainer	encadreur
traitor	traître
transaction	transaction
transalpine	transalpin
transcribe	transcrire
transfer	transfert
translate	traduire
translation	traduction
translator	traducteur
transmit	transmettre
tree	arbre
truck	camion
two	deux
ubiquitous	omniprésent
ubiquity	ubiquité
udder	pis
ugh	pouah
uglier	plus laid
ugliest	le plus laid
uglify	enlaidir
uglily	laidement
ugliness	laideur
ugly	laid
ukulele	guitare hawaïenne
ulcer	ulcère
ulcerate	ulcérer
ulcerated	ulcéreux
ulceration	ulcération
ulcerative	ulcératif
ulna	cubitus
ultimo	du mois dernier
unemployment	chomage
vacant	libre;
vacate	quitter
vacation	vacances
vaccinate	vacciner
vaccinated	vacciner
vacuum	aspirateur 
vacuumed	passer à l'aspirateur
vagina	vagin
vagrant	vagabond
vague	vague;
vain	vain;
wacky	drole
wag	remuer
walnut	la noix
warehouse	entrepot
warehouse	entrepôt
warehouses	entrepôts
wash	laver
weep	pleurer
weeping	pleurs
weeping	qui pleure
weeps	pleure
weepy	larmoyant
weepy	mélo
weevil	charançon
weft	trame
weigh	mesurer
weigh	peser
weighing	pesée
weighings	pesées
weighs	pèse
weight	poids
weighted	lesté
weighted	pondéré
weightily	avec force
weightily	puissamment
weighting	lestage
weighting	plombage
weightless	état d'apesanteur
weightlessness	apesanteur
weights	attache un poids à
weights	série de poids
weighty	lourd
weighty	pesant
weir	barrage
weird	bizarre
weird	étrange
weirdie	excentrique
weirdies	excentriques
weirdly	étrangement
weirdness	caractère étrange
weirdness	étrangeté inquiétante
weirdo	excentrique
weirdos	excentriques
weirs	barrages
welcome	agréable
welcome	bienvenu
welcome	bienvenue
welcome	souhaiter la bienvenue à
where	où
window	la fenêtre
window	le guichet
windowpane	la glace
windowpanes	les glaces
windows	les fenêtres
windshield	le parebrise
windstorm	la tempête
windup	remonter
wine	le vin
wineglass	le verre de vin
winegrower	le vigneron
winemaker	l'encaveur
winemaking	la vinification
winepress	le pressoir
wines	les vins
winey	viticole
wing	l'aile
winglet	l'aileron
wink	un clin d'oeil
winter	l'hiver
wipe	essuyer
wire	fil métallique, fil de fer
wire	telegramme
wire	telegraphier ; faire l'installation electrique
wired	branche , sonorise
wireless	sans fil
wiring	installation electrique
wiry	raide, rude ; maigre et nerveux
wisdom	sagesse
wise	sage, prudent, savant
wisecrack	astuce, sarcasme
wisely	sagement, prudement
wiser	plus sage
wish	desir, souhait
wish	desirer, souhaiter qch
wishbone	brechet
wishes	pl de wish, desir
wishful	 vif
witch	sorcière
witches	sorcières
with	avec
withdraw	retirer
withdraw	se retirer 
without	sans
witness	témoigner
witness	témoin
witnesses	témoins
wolverine	le carcajou
wolverine	le glouton
world	le monde
worldwide	mondial
xenophobe	xénophobe
xenophobia	xénophobie
xenophobic	xénophobe
xerographic	xérographique
xylem	xylème
xylene	xylène
xylophone	xylophone
xylophones	xylophone
xylophonist	joueur de xylophone
xylose	xylose
xylotomic	xylotomique
yacht	yacht
yachting	yachting
yachtsman	yachtsman
yak	yack
yam	patate douce
yank	tirer d'un coup sec
yap	japper
yard	yard
yardstick	mesure
yarn	fil
yawn	bâillement
yawn	bâiller
yawning	bâillement
yeah	ouais!
year	année
yearbook	annuaire
yearlong	annuel
yearly	annuel
yearly	annuellement
yearn	désirer
yearning	désir
yearningly	désireux
years	années
yeast	levure
yell	hurlement
yell	hurler
yellow	jaune
yellowed	jauni
yellowing	jaunissant
yellowish	jaunâtre
yes	oui
yesterday	hier
yet	encore
yew	if
yield	produire
yoga	yoga
yoghurt	yaourt
yogurt	yaourt
yoke	joug
yolk	jaune d'oeuf
you	vous
young	jeune
younger	plus jeune
youngster	jeune
youth	jeunesse
youthful	juvénile
yuppie	yuppie
zabaglione	sabayon
zany	dingue
zazen	zazen
zeal	zèle
zealous	zélé
zebra	zèbre
zenith	zénith
zero	zero
zero	zéro
zest	piquant
zigzag	zigzaguer
zinc	zinc
zipper	fermeture
zodiac	zodiaque
zodiac	zondiaque
zone	zone
zone	zone
zoo	zoo
zoology	zoologie
zoom	aller en trombe
zucchini	courgette
