cancel	cancelar
acutely	agudamente.
tranquilized	tranquilo
half	medio
omens	agüeros
accouterments	equipo
abrupt	brusco (sudden); áspero (curt)
salary	el sueldo
theorists	teóricos
tranquilizer	tranquilizante
tea	té
tranquilizes	tranquiliza
drunk	borracho
stereochemistry	estereoquimica
ten	diez
seamstress	modista
chopstick	palíllo chíno
abrasively	bruscamente (manner)
incited	incitdo(a)
incites	incita
inciter	incitar
poems	poemas
toasters	tostadoras
amusing	divertido
jackass	burro
abductor	secuestrador
hang	colgar
cliff	el acantilado
fearless	arrojado
I	yo
blond	rubio
taxicabs	taxis
gold	el oro
result	la resulta
macrocosmically	macrocosmicamente
same	mismo
underused	infrautilizado
staircase	la escalera
hand	la mano
topcoat	sobreabrigo
b	b
c	c
salt	la sal
e	e
tabletop	mesa
laden	cargado
h	h
i	yo
j	j
helium	helio
weeping	lloroso
eating	comiendo
blood	la sangre
neighbor	la vecina
o	or[conjunction]
straight	derecho
laded	cargado
q	q
r	net(la red)
sale	la liquidacion
readers	lectores
cancan	cancan ( the dance)
information	informacion
plasma	plasma
chemises	camisas
earths	las tierras
good	bueno
obese	obeso
faithful	fiel
suede	el ante
tic	tic 
fiance	prometido
tie	atar
lubricous	lúbrico
tin	lata
serious	serio
factionalism	faccionalismo
tip	propina ( gratuity) consejo ( advice)
aficionado	aficionada (fan) -m
laugh	reirse
tit	teta ( as in breast
cinder	ceniza (ash)
puddles	charcos
seacoasts	costas del mar
abated	aplacado
aficionada	aficionada (fan) -f
dichroism	dicroismo
sand	la arena
peppermint	la menta
categorically	categóricamente
abstracter	abstractor
harm	dañar
rope	la cuerda
aboriginal	aborigen
abstracted	abstracto
polemist	polemizador
fulfillments	obligaciones
flannel	la franela
thieves	ladrones
abater	rebajador
abates	satélites
cabbies	los taxistas
hard	tieso
hare	liebre
multiply	multiplicar
bactericide	bactericida
roof	el techo
theologic	teológico
umbrella	paraguas
caliber	calibre
temerarious	temerario
lapels	las solapas
raffle	rifa
room	sala
plasmagenic	plasmagénico
better	mejor
haggard	ojeroso
omnivorous	omnivoro
poignant	punzante
cancer	cáncer
abrasions	abrasiones
exiguousness	exigüedad
madmen	locos
terrifying	espeleznante
fountain	la fuente
catalog	catálogo
narcissist	narcisista
abstractor	abstractor
salespeople	dependientes
abreact	liberar emociones verbalmente
chills	escalofríos (ned)
block	bloque
hate	odiar
magnitudes	magnitudes
therapist	terapéuta
backtracker	desandador
movie theater	el cine
abbeys	abadías
timid	tímido
traveling	viajando
helicoidal	helicoidal
anthill	hormiguero
macabrely	de manera macabra
tombstones	tumbas
raincoats	los impermeables
backtracked	desandado
podium	posio
castrated	castrado
vaccination	vacuna
pink	rosado
woman	la mujer
poetically	poéticamente
save	ahorrar
plumulate	plumulado
toe	dedo del pie
aborigines	aborigenes
luckiness	suerte
abscess	absceso
cameras	camaras
ton	tonelada
top	cima
too	también
ladle	cucharon
have	tener
harmonic	armónico
jagged	dentado
toy	juguete
taller	más alto
caboodle	montón
backlogs	atrasos
famous	famoso
question	la pregunta
calibre	calibre
picture	el cuadro
abutment	lindero
chickadee	bohío
sarcastic	sarcastico
disable	inutilizar
tortures	torturas
babbling	balbuceando
torturer	atormentador
rose	la rosa
oceanographer	oceanografo
captives	cautivos
thousand	mil
raptor	el raptor
symphonic	sinfónico
tortured	torturado
fuckers	chingadores
cow	la vaca
quack	matasanos
counterrevolutionaries	contrarrevolucionarios
madman	loco
pacify	apaciguar
abilities	talentos
academia	academia
exhortative	exhortativo
academic	académico
chloride	clorúro
pipe	la pipa
longitude	la longitud
pigeon	la paloma
abstractly	abstractamente
actress	una actriz
badgering	molestando
taboos	tabúes
plenty	lleno
bandits	bandito
obligation	obligación
racehorse	 el caballo de carrera
acidic	ácido
calendula	caléndula
cemeteries	cementerios
chicken	pollo
mailman	el cartero
obeys	obedece
oceanographic	oceanografico
hazy	brumoso
occurrent	ocurrente
haze	la bruma
salads	ensaladas
exhorted	exhortado
muscle	el músculo
caboose	fogón; cocina
alcoholic	alcoholico
bachelor	soltero
abacuses	ábacos
cry	llorar
totals	sumas
charades	charadas
pineapple	la ananá
activities	las actividades
chiropractic	quiropráctica
abducted	separado de la línea media del cuerpo.
narcissism	narcisismo
stubbly	lleno de rastrojo
incident	incidente
mayonnaise	la mayonesa
weekends	fines de semana
concert	el concierto
teleconferencing	teleconfiriendo
stubble	rastrojo
beautiful	hermoso
oceanarium	aquario
worked	trabajó
hackers	piratas informáticos
casaba	casaba ( vegetable )
accuser	acusador/ra
accuses	acusas
worker	trabajador
machinist	maquinista
appointments	las citas
synagogue	sinagoga
jackal	chacal
piss	mear
chortle	reir(se)
stereotype	esterotipo
salesmen	dependientes
cup	la taza
cut	cortar
harass	molestar
two	dos
chemists	químicos
teat	teta
celery	el apio
abiotic	abiótico
tear	romper
calmly	calmadamente
teas	tés
skinny	flaco
worried	preocupado
kitchen	la cocina
shout	gritar
ankle	el tobillo
inclination	inclinación
think	pensar ( to think)
participate	participar
languages	las lenguas
occurred	ocurrió
biochemical	bioquimico
accused	acusadóda
absolution	absolución
acceleratingly	aceleradamente
team	equipo ( as in football)
torture	tortura
lockout	el lockout
speech	discurso
watch	el reloj
purple	morado
cabinet	gabinete
thing	la cosa
tooted	pitó
actualize	actualizar
thigh	muslo
tedious	tedioso
telecommunication	telecomunicación 
terrestrial	terréstre
paying	pagando
chrysanthemum	crisántemo
lackadaisical	apatico
tameable	domable
actual	actual
glass	el vidrio
homebuilder	constructor
campus	recinto
anthropomorphism	antropomorfismo
gooseberry	grossella espinosa
jacket	la chaqueta
weeper	llorona
sabbatic	sabático
incisor	incisor
abducentes	abducentes
technologies	tecnologías
easiest	el mas facil
machining	maquinando
alarmingly	alarmantemente
memory	la memoria
house	casa
taverna	taberna
disaster	el desastre
tactfully	discretamente
chessman	pieza de ajedrez
taverns	tabernas
machineries	maquinarias
hours	las horas
acceptingly	con aceptación
libraries	las bibliotecas
cursive	cursiva
footnote	nota a pie de página
teen	adolescente
earliest	el mas temprano
lachrymator	lacrimogeno
stubbed	desarraigar
chlorine	clóro
teem	pulular
fallen	caido
hotels	los hoteles
short	corto
gruelling	penoso
abreast	de frente: "to keep abreast of" (fig): mantenerse al corriente de
attitudes	actitudes
ninety	noventa
facade	fachada
acceding	accediendo
trains	trénes
candies	caramelos
climb	subir
telethon	teletón
karate	karate
absolutize	absolutizar
jackals	chacales
toothpicks	modadientes
catalogues	catálogos
enter	entrar
gallery	galería
flowers	las flores
quadrant	cuadrante
destroy	destruir
daedal	intrincado; completo
absorptance	absortencia
wintering	pasando el invierno (en algun sitio)
telescopes	telescopios
thirties	los trenta
dolls	muñecas
cactuses	cactos
wacke	roca basáltica
cinematography	cinematografía
dacha	dacha
waddle	nalguear
acyclic	acíclico.
motionless	estatico
crutch	muleta
wallet	la cartera
celebrates	festeja
acrobats	acróbatas
ante	apuesta(poker); ante...
agoraphobia	agorafobia
fetch	traer
candied	acaramelado
earldom	condadó título
abstriction	abstricción
quadruped	cuadrúpedo
oasis	oasis
dab	untar
dad	padre
tell	contar
dam	represa
daughters	hijas
celebrated	festejó
exhort	exhortar
goodnight	buenas noches
day	día
accustomed	acostumbrado
quadruple	cuádruple
lacerations	laceraciones
island	la isla
theological	teológico
water	el agua
fried	frito
acrostic	acróstico
madwoman	mujer loca
fidget	agitarse
meekness	mansedumbre
fervor	el fervor
babblement	balbuceo
torrents	torrentes
salesman	el vendedor
raisins	las pasas
apples	manzanas
tens	décimos
tent	carpa
adiposity	adiposidad
tabernacle	tabernáculo
comedian	cómico
tend	cuidar
beaming	radiante
tones	tonos
dated	fechado
introduction	introducción
checkbooks	chequeras
temp	temporario
absolutism	absolutismo
therapy	terápia
chromosome	cromosóma
thesaurus	tesauro
chauffeur	chofér
noticing	notando
lecturer	conferensista
threads	hilos
absolutist	absolutista
incises	incisos
diamond	el diamante
third	tercero
tolerate	tolerar
underline	subrayar
chopsticks	palíllos chínos
tramcar	tram
gravitation	gravitacion
wasps	avispas
preacher	predicador
preaches	predica
abusing	abusando
announcement	anuncio
carefully	cuidadosamente
going	i am going: voy  you are going: va  we are going: vamos  they are going: van
macrophage	macrófago
pancake	panqueque
buyer	comprador
cabbaging	repollando
flakes	copos
attitude	actitud
accedes	consentir en
treatment	tratamiento
pluralism	pluralismo
waited	perdado
testaments	testamentos
grass	la hierba
weighty	ponderoso
brag	bravata; jactarse & fanfarronear(v)
bactericidally	bactericidamente
hotel	el hotel
brae	ladera de monte; pendiente
term	término
acquisition	adquisición
backslash	barra invertida (\)
brad	puntilla; clavito
accords	acuerdos
oligarchy	oligarquia
business	el negocio
posters	carteles
possible	posible
right	verdad
aboriginally	aboriginalmente
chestnut	castaña
shoes	los zapatos
flagpoles	astas
polarizer	polarizador
stealing	taking
polarizes	polariza
plenipotent	plenipotente
oakwood	madera de roble
lucubrate	lucubrar
balsam	balsamo
backspacing	retrocediendo
waiter	el mozo
desert	el desierto
polarized	polarizado
under	bajo
did	past of do.
finch	pinzón
die	morir
tolerant	tolerante
happiest	happy
backpacks	mochila
leathern	de cuero
musicologist	el musicólogo
dangerously	peligrosamente
plurality	pluralidad
achromaticity	acromaticidad
passport	el pasaporte
poignancy	viveza
forgotten	olvidado
accordances	concordancias
internationals	internacionales
laces	cintas
test	exámen
dactylic	dactílico
finally	al fin
calisthenic	calisténico
thereafter	después
grape	la uva
brown	pardo
straw	la paja
feast	fiesta
acceded	accedió
acceptance	aceptación
narrowing	estrechando
pluralist	pluralista
churchless	sin iglesia
loan	el préstamo
mace	mazo
telefacsimile	telefacsímile
back	lomo (noun)
guzzle	tragar; engullir
training	training center
machete	machete
incestuously	incestuosamente
pound	la libra
accusor	acusador/ra
load	la carga
censuses	apadronamientos
ladylike	afeminado
loaf	holgazanear
applaud	aplaudir
abusive	abusivo
relax	relajar
trafficker	traficante
babe	nena
schedule	el horario
achromatic	acromático
uno	one
baby	criatura
abalones	abulónes
adverb	el adverbio
qualified	(certified) acreditado
lunch	el almuerzo
bacchic	báquico
lesbianism	el lesbianismo
oligarchical	oligarquico
attempt	intento
thick	grueso
tiles	lozas
December	diciembre
balance	balancear
sadomasochistic	sadomasoquista
iconoclast	iconoclasta
lock	la esclusa
loch	el lago
text	texto
kindness	la bondad
made	hecho
statue	la estatua
plethora	plétora
timidly	tímidamente
anion	anión
lobe	el lóbulo
thumbtack	la chinche
dog	la perra
towing	remolcando
steelwork	acería
bags	bolsas
magi	los reyes magos; sacredotes de la relig. zoroastrica
thief	ladrón
chunks	trocítos
calmed	calmado
stamp	el sello
abomination	abominación
government	el gobierno
known	conocido
absinthe	absenta
dirtying	ensuciando
nurse	la enfermera
accumulate	acumular(se)
crime	el crimen
acquaintances	conocidos/das
cigarette	el cigarro (mex)
policewoman	policía
lacks	le falta
pluralize	pluralizar
cabbages	coles
zealous	celoso
cabbaged	repollado
madhouse	manicomio
incest	incesto
bait	cebo
mail	el correo
subject	asignatura
use	usar
sadness	tristeza
bail	pelota
magistrally	magistralmente
logo	el logotipo
maid	la criada
cheerfully	alegremente
macaque	macaco
loft	el desván
motivated	motivado
broom	la escoba
dry	seco
poisoned	envenenado
weights	pesos
yule	pascua de navidad
labelled	etiquetado
tabernacles	tabernáculos
poisoner	envenenador
cantaloupe	melón
fidelity	la fidelidad
tachyons	taquión
tilde	tilde
negotiating	negociando
activates	activa
stain	la mancha
absentees	ausentes
ball	la pelota
napkin	la servilleta
bale	el fardo
bald	desgastado(a)
threats	amenazas
loin	el lomo
make	hacer
categorize	catalogar
tiled	enlozado
policewomen	policías
banal	banal
thread	hilo
yuppies	yuppies
beaker	vaso de precipitados
rapidly	rapidamente
adaptations	adaptaciones
bytes	los bytes
bake	hornear
threat	amenaza 
pumpkin	la calabaza
activated	activado
musicology	la musicología
friendships	amistades
tabulators	tabuladores
trees	arboles
bank	el banco
abiologically	abológicamente
cholesterol	colesteról
magnetic	magnético
band	banda
boxes	las cajas
radars	radares
mammography	mamografía
labor	parto (childbirth)
machinists	maquinistas
tragicomic	tragicómico
mackintosh	mackintosh
safari	safari
accumulatively	acumulativamente
lone	solitario
long	largo
remember	recordar
cedar	cedro
abyssal	abisal
identifiable	identificable
oligarch	oligarca
workers	trabajadores
bother	molestar
childhood	niñez
star	la estrella
wolf	el lobo
quadripartitely	cuatripartitamente
cardiovascular	cardiovascular
many	muchos
stay	quedar
loll	rapantigarse
backwardness	atraso
eyeglasses	eyeglasses
gadgets	artilugio
agent	agente -m
treat	golosina ( sweets)
wool	la lana
abortion	aborto (acción)
macaronic	macarronico
rapid	rápido
seven	siete
arena	corrida
nakedness	desnudez
specs	las gafas (de "spectacles")
loom	telar
barn	el troje
wood	la madera
abrogate	abrogar
admitted	vt (pret & pp) - (to be admitted) internarse
surprise	la sorpresa
seashells	conchas marinas
sealed	sellado
countdown	cuenta regresiva
addicts	adictos
look	ver
therapeutist	terapeúta
achieving	que logra
disrupt	transtornar
telecommunicate	telecomunicar
scar	la cicatriz
thyroid	tiroide
abduced	abducido
knock	tocar
plasmid	plásmido
daybook	libro dia
contemptible	vil
censored	censurado
speed	la velocidad
abysses	abismos
apple	manzana
admit	vt - (to the hospital) internar
adrenalin	n  - adrenalina
themselves	ellos mismos
magnolias	magnolias
twin	gemelo
cadaverine	cadaverina
chaste	casto
mask	máscara
canary	canario
abjections	abyecciones
barbarian	bárbaro
aborting	abortando
abnormalizes	anormaliza
lemonade	limonada
eagerly	anciosamente
raped	violó
pluralization	pluralización
terraqueous	terráqueo
abacus	ábaco
dalmatian	dalmata
ceasefire	cese al fuego
commas	comas
tabletops	mesas
babysitting	cuidar niños
callus	callo
shovels	palas
incentive	incentivo
fabricant	fabricante
lost	perdido
tomes	libros
hacienda	hacienda
stealth	not sure
capitalists	capitalistas
mopper	trapeador
abatis	tala
work	trabajo
lose	perder
macroevolution	macroevolucion
tattoo	tatuáje
tragedies	tragedias
tinted	teñido
activator	activador
word	la palabra
theory	teoría
inoffensive	inofensivo
love	love
internetwork	connección interna de comunicación
castanet	castañuela
acropetal	acropetálico
architect	el arquitecto
forehead	la frenta
secret	el secreto
across	a través
antagonistic	antagonico
mortgage	hipoteca
ear	oreja
poinsettia	poinsetia
eat	comer
loud	ruidoso
juice	joco
soldier	el soldado
incarnation	renacer
insult	insultar
termite	comején
caldera	caldera
basketball	baloncesto
expressive	expresivo
tisane	tisana
spell	el hechizo
backhand	reves
aberration	desviación
cavity	carie ( dentist)
coffeepot	la cafetera
flagellation	flagelacion
combustion	combustión
tombs	tumbas
commence	comenzar
tickets	tiqués ( theater)
magisterium	magistreio o autoriad delo
trajectories	trayectorias
winter	el invierno
clouds	las nubes
platform	plataforma
anteroom	antesala; antecamara
spend	gastar
accompaniment	acompañamiento
February	febrero
tenants	inquilinos
grave	grave
advantage	la ventaja
telegram	telegrama
cloudy	nublado
accustoming	acostumbrando
abortive	malogrado
with me	conmigo
fabricate	fabricar
macrosocioeconomic	macrosocioeconómico
calamine	calamina
habitat	hábitat
hands	las manos
egg	el huevo
transcendentalist	trascendentalista
year	año
yeah	si
branch	la rama
acculturated	aculturado
themes	temas
calamint	ajedrea
doctrinal	doctrinal
chromatography	cromatografía
absent	ausente; 
neat	pulcro
understanding	comprensión
near	cerca
silence	el silencio
flagellant	flagelante
transcendentalism	trascendentalismo
fairy	la hada
carbohydrates	carbohídratos
ragged	desigual
economy	econom'ia
ailment	mal -m; achaque -m; padecimiento
packet	paquete
macaroni	macarrones
chandeliers	chandeliéres
stop	pararse
calamus	acoro
adolescence	n  - adolescencia
sinecure	sinecura
taxicab	taxi
peaches	duraznos
logbook	el diario de a bordo
abrasion	raspón
cede	ceder
measurement	medicion
censors	censuradores
symphony	sinfonía
backwoodsman	bosquímano
macaroon	macarrón
obelisk	obelisco
catastrophic	catastrófico
abidingly	permanentemente
identically	idénticamente
musician	el músico
computers	computadoras
annotation	anotación
learn	aprender
pineapples	las ananás
neck	el cuello
logical	lógico
dalmatians	dalmatas
newer	mas nuevo
theologically	teológicamente
leash	correa
steelmaker	acerero
brandy	brandy
abstemiously	de forma abstemia
cholinesterase	colinesterása
dancers	bailarines
taxis	taxis
stud	tachón
achieves	logra
babysitters	niñera
stereochemist	estereoquimico
achiever	persona que logra sus metas
lucidly	lúcidamente
spring	saltar
chaser	perseguidor
leave	salir
stub	trozo
internationalists	internacionalistas
cakes	tortas
testa	cabeza ( head)
e'er	contracción de "ever": siempre
need	necesitar
laicization	laicizacion
catastrophes	catástrofes
typewriter	la maquina de escribir
brainless	estupido; insensato
cephalic	cefálico
obediences	obediencias
tests	exámenes
testy	hósco
traditions	tradiciones
loose	suelto
private	privadóprivada
tadpoles	renacuajos
calamite	calamites
accordionist	acordeonista
saleslady	dependienta
accumulators	acumuladores
counterclockwise	contra las agujas del reloj
narcotic	narcótico
sleeping	durmiendo
calamity	calamidad
accomplish	cumplido
end	el fin
packed	guardado (that's just 1 meaning)
lizard	lagarto
magniloquently	magnilocuentemente
forty	cuarenta
cipher	la cifra
chased	persiguió 
dammit	maldición
plasmids	plasmidios
quadrangular	cuadrangular
special	especial
contempt	menosprecio
environment	ambiente
cheerily	alegremente
achieved	logró
calmness	tranquilidad
pronounce	pronunciar
lackadaisically	apaticamente
airsickness	mareo 
occupation	ocupación
anthropocentric	antropocentrico
called	llamó
hotdogs	el pancho
nationalities	nacionalidades
ohms	ohms
liberate	liberar
occurs	ocurre
gangster	pandillero
explode	estallar
narrow	estrecho
abrasive	brusco (manner)
passively	pasivamente
quadrature	cuadratura
jackdaw	grajilla
shape	la forma
seventy	setenta
stealer	taker
harassed	acosada
gravel	grava
giraffe	la jirafa
charming	encantador
saffron	azafran
singer	el cantor
acidulation	acidulación
accusations	acusaciones
cell	cédula
hadn't	no ha
tormenting	atormentando
brainchild	parto del ingenio; invento
cataclysm	cataclismo
antarctic	antartico
television	televisión
chairman	presidente
sharp	agudo
temperament	genio
spinach	la espinaca
cent	el centavo
screen	pantalla
transfusion	transfusión
naked	desnudo
trial	juicio
absorbency	absorbencia
cabalistic	cbalístico(a)
trafficking	traficando
canals	canales
charlatan	charlatán
below	bajo
acoustic	acústico
magistral	magistral
yelp	gañir
underutilize	infrautilizar
brass	metal
pancakes	panqueques
churned	revuelto (a)
quackery	charlatanería
careers	profesiones
yell	grito
races	carreras
tribe	tribú
activate	activar
therefor	entonces
abstracting	abstrayendo
centric	céntrico
xylophone	xilófono
exigently	exigentemente
ferocity	la ferocidad
raced	él competió
raining	lloviendo
dreams	sueños
trick	truco
timidness	timidez
transcendentalize	trascender
calcimine	encalar
vodka	el vodka
chose	escojer
France	la francia
tergiversator	tergiversador
rollers	rodillos
announcers	anuciadors
raincoat	el impermeable
obediently	obedientemente
antelope	antilope
tightwads	tacaños
abstraction	abstracción
drawer	la gaveta
rabies	rabia
adjacent	adyacente
pencil	lapiz
chore	la tarea
appetite	el apetito
needle	la aguja
strategy	estrategia
teases	molesta
caviar	caviár
talkative	hablador ( noun)
achievements	logros
cedilla	cedilla
annihilate	aniquilar
accusation	acusacion
rabid	rabioso
chemicals	químicas
karateist	karateca
waves	olas
encompass	englobara
calaboose	calabozo
hackmatack	happy birthday
eye	el ojo
envelope	el sobre
acclaims	aclamar
rumba	rumba
wanted	querido (m)
toothache	dolor de muelas
continent	el continente
brackish	salobre; semisalado
occult	oculto
tints	tintes
comeback	regresar
tastefully	gustosamente
gray	gris
waterfall	la catarata
backbone	lomo
stubbing	desarraigar
laborsaving	que ahorra trabajo
magician	mago
magnesia	magnesio(a)
cemetery	el cementerio
abominator	abominador
black	negro
liberation	la liberación
cantina	cantina
nest	el nido
calcifuge	calcífugo
baggily	holgadamente
describe	describir
sarcasm	sarcasmo
suck	chupas
campuses	recintos
foam	la espuma
polarizers	polarizadores
administration	n  -  administracion -f  (accent over  o)
internalized	internalizado
topographically	topográficamente
acculturate	aculturar
white	blanco
counterpart	contraparte
grapefruit	la toronja
internalizes	internaliza
occupants	ocupantes
lackluster	sin brillo
greenish	verdoso
odometer	odometro
antacid	antiacido
transcontinental	transcontinental
cabinetmaker	ebanista
expressions	expresiones
incaution	descuido
harelipped	leporino (labio)
acetaminophen	acetaminofén
museum	el museo
clothing	la ropa
tachycardia	taquicardia
tamarind	tamarindo ( the fruit)
accomplice	cómplice
occupy	ocupar
fucus	enfocar
traditionalists	tradicionalistas
feldspar	feldespato
abductors	secuestradores
macabre	macabro
maddest	lo m/as enfadado
typist	el (la) mecanógrafo(a)
habeas	habeas
topaz	topacio
backyard	patio de atras
wad	tapón o corcho
wag	mover
news	las noticias
rack	rejilla
green	verde
race	(ethnicity
radiosensitivity	radiosensitividad
was	fue 
war	la guerra
sculpture	la escultura
way	la via
wax	la cera
window	la ventana
daffodils	narcisos
polarizables	polarizables
play	tocar
amalgamated	amalgamado
fought	luchado
cacuminal	cacuminal
pacifistically	pacíficamente
quickly	rapidamente
abracadabra	abracadabra
raft	baba
attentive	atento
decide	decidir
baffler	deflector
stubs	trozos
moribund	moribundo
arteriosclerosis	arteriolosclerosis
fan	el ventilador
far	lejos
prostitute	prostituta
stuck	picar
titans	titanes
abraded	raído
fat	gordo
greed	codicia
baffled	confundido
sacerdotal	sacerdotal
rained	llovió
applesauce	pure de manzana
comfortable	cómodo
tranquility	tranquilidad
suit	el traje
necktie	la corbata
chocolate	el chocolate
tergiversation	tergiversión
study	estudiar
fever	calentura
symposia	simposio
chocolaty	achocolatádo (a)
machinelike	parecido a una máquina
web	tejido tela telaraña enredo red trama
wed	casarse
tragic	trágico
older	mayor
categories	categorías
quaint	pintoresco
castles	castillos
tornado	tornado
lachrymal	lacrimal
wet	mojado
electricity	electricidad
hailstone	granizo
climate	el clima
quadratic	cuadrático
calenture	calentura
ballistics	la balística
great	gran
narcissus	narciso
rags	los trapos
macroprocessor	macroprocesador
thenceforth	desde entonces
circumference	la circunferencia
rage	rabia
screws	tornillos
statistics	estadística
dick	 declaracion
monkey	el mono
disability	inhabilidad
abnegate	(auto)sacrificarse
malignant	maligno
rumor	el rumor
few	pocos
antechamber	antecamara; antesala
snacks	aperitivos
abstractness	abstracto
sinful	pecaminoso
thankfully	agradecidamente
rain	llover
canaries	canarios
tornadoes	tornados
rail	(railroad) vía
halfcircle	semicirculo
tranquil	tranquilo
tortilla	tortilla ( omelet )
choleric	colérico
absenteeism	absentismo
oiler	aceitera
backlog	lista de cosas pendientes
cereal	cereal
habitus	habito
outside	afuera
topic	tema
forgets	olvida
oiled	aceitado
totality	totalidad
raid	incursión
overprice	sobreprecio
game	el juego
pacemaker	marcapasos
faith	la fe
why	por qué
acclimates	aclimatar
died	muerto
radiosensitive	radiosensitivo
strikebreaker	rompahuelgas
candidate	candidato
damned	condenado
cashier	el cajero
peanut	el cacahuate
acclimated	aclimatado
macrocephalous	macrocefalo
win	ganar
lawyer	el abogado
racetrack	hipódromo
soccer	f&uacute;tbol
butter	mantequilla
chromium	cromo
gator	crocodilibus
cannibal	caníbal
totalism	totalismo
hailstorm	tormenta de granizo
recommended	recomendado
theaters	teatros
adenine	adenina
fulfillment	obligacion
headache	dolor de cabeza
visit	visitar
fib	mentirilla
gala	gala
absorbability	capacidad de absorber
fig	el higo
arteries	las arterias
luckily	afortunadamente
trembles	tiembla
teatro	teatro ( theater )
palazzo	palacio
honest	honrado
rank	(level) nivel
trembled	tembló
ablaze	ardiente
palazzi	palacios
rang	sonó
teats	tetas
addition	adición
aborning	naciente
gang	banda
grow	crecer
sure	seguro
aggressions	agresiónes
brainstorm	idea genial
excited	excitado
shrink	encoger
am	2486
salsa	salsa
fold	doblar
at	a
yonder	ahí allá
checkbook	chequera
internalization	internalización
looking	viendo
be	ser
prove	probar
iciest	lo más helado
cherished	querido
admire	admirar
pickle	el encurtido
intimacy	intimidad
rape	violar
accusing	acusando
accomplishers	terminadores
tactically	t'acticamente
abandonment	abandono
foot	el pie
tooth	el diente
radiance	brillantez (f)
salty	salado
tittie	tetica ( as in titties
charge	cargar ( batteries)
tombstone	tumba
tranquilize	tranquilizar
keeping	custodia
adobe	adobe
cacophonous	cacofónico
laborists	los laboristas
sexless	sin sexo
breathe	respirar
flu	la influenza
food	comida
fly	volar
cholinergic	colinérgico (a)
kilometer	kilómetro
acquisitions	adquisiciones
interview	la entrevista
testimonialize	dar testimonio
naive	ingenuo
bachelorhood	solteria
traumas	traumas
accomplisher	terminador
scarf	la bufanda
tearjerker	arrancalágrimas
accomplishes	termina  terminó
language	el lenguaje
arterial	pertinente al transito
do	hacer
painfully	dolorosamente
accomplished	terminado
Friday	el viernes
rare	raro
workbench	mesa de trabajo
caricature	caricatura
tiredness	cansancio
harmonical	armónica
topography	topografía
internals	internos(as)
never	nunca
terrorizers	terroristas
taffy	caramelo (de az'ucar fundida)
elephant	el elefante
fog	la neblina
abeyance	iñ en desuso
christening	bautízo
tears	rasga
for	por
placentation	placentación
loneliness	la soledad
jackhammer	taladradora
content	satisfecho
fox	el zorro
mustache	el bigote
achievable	lograble
baccalaureate	bachillerato
stuccowork	estucado
contend	contender
calcifugous	calcífugo
thence	desde allí
go	ir
abrades	raspar
abased	humillado
abrader	que raspa
accumulations	acumulaciones
chewing	masticando
tease	molestar
fork	el tenedor
ha	ja
zodiacal	zodiacal
wrestling	lucha libre
he	él
feather	la pluma
habilitated	habilitado
placed	situado
anthropophagous	antropofago
tabulate	tabular
speechless	sin habla
capricious	caprichoso
abhor	aborrecer
habilitates	habilitar
abscessed	abscesado
four	fourty
contemplate	proyectar
easily	facilmente
habitably	habilidad
if	si
limes	las limas
zinc	cinc
bathroom	el bano
abscesses	abscesos
talker	hablador
plates	láminas
accusative	acusativóva
snorkelear	to snorkel
canasta	canasta ( basket)
announce	anunciar
sadism	sadismo
somebody	alguien
additive	aditivo )adj & noun)
certification	acreditadación
habitable	habitable
talked	habló
sadist	sadista
cheeseburgers	hamburguesas de queso
plumulose	plumuloso
fetus	feto
affinity	n  - affinidad  -f
accomplishable	terminable
accrue	aumentarse
eagerness	ansia
occurrence	ocurrencia
acetate	acetato
literature	la literatura
accomplices	cómplices
ablate	extirpar
ability	talento
abyss	abismo
calibration	calibración
personify	personificar
plugged	enchufado
knew	sabia
ablaut	quesontes
calculability	calculabilidad
lantern	la lámpara
paganism	paganismo
pasteurize	pasteurizar
cannibals	canibales
knee	la rodilla
chronologically	cronologicaménte
oceanographically	oceanograficamente
calibrating	calibrando
acrobacy	acrobacia
saccharose	sacarosa
chalkboard	pizarra
ciliary	ciliario (a)
accomplishment	triunfo
certify	acreditar
locket	el medallón
while	mientras
contentment	contento
locker	el casillero
laudable	digno de loor
salve	ungu.ento
second	el segundo
that	eso
tagalong	sucesi'on
ma	mamá
labradorite	labradorita
skirt	la falda
www	rim (red mundial interna)
limit	el límite
enzymatically	enzimaticamente
benchmarks	evaluaciones comparativas
cabling	cableado
mi	me
thaw	descongelar ( to thaw)
cabinets	gabinetes
tolerance	tolerancia
abstaining	abstinente
plum	la ciruela
incertitude	incierto
contest	el concurso
author	el autor
greenhouse	invernáculo
charms	amuletos ( noun)
feeling	sentimiento
plus	añadido
license	la licencia
dish	el plato
dream	soñar
preachers	predicadores
plug	clavija
yucca	yuca
totalitarian	totalitario
heat	el calor
tireless	sin cansancio
labium	labio
student	estudiante
careful	cuidadoso
seal	foca; sello
terrorists	terroristas
seam	costura
head	doument
radiobroadcast	transmisión de radio
imported	importado
of	de
living room	la sala
artfully	astutamente; ladinamente; artificiosamente; con artificio; con arte; diestramente
capacities	capacidades
incarcerating	encarcelando
occupied	ocupado
or	o
incarceration	encarcelación
sports	los deportes
tendencies	tendencias
documental	documental
cousin	el primo
occupies	ocupa
intelligent	inteligente
rabbi	rabino
walnut	la nuez
incessantly	incesantemente
kisses	besos
easier	mas facil
luxury	el lujo
macromolecule	macromolecula
salad	la ensalada
catacomb	catacumba
nation	nación
meditations	meditaciones
adaptation	adaptación
fucking	chingando
scarlet	escarlata
freeze	helar
tongues	lenguas
brand	marca
January	enero
recent	reciente
they	ellos
choke	estrangular
bagatelle	bagatela
caudal	caudal
anthropological	antropologico
them	ellos
then	entonces
nationalization	nacionalización
seat	el asiento
seas	mares
abortionist	abortista
adopt	vt  - adoptar
teachings	enseñanzas
chauvinism	machismo
placenta	placenta
earache	dolor de oreja
bridge	el puente
chauvinist	machista
chronically	cronicaménte
waistcoat	el chaleco
bells	las campanas
macaronically	macarronicamente
seed	la semilla
seashell	concha marina
magisterially	magistralmente
macadamized	alquitranado
seek	buscar
seem	parecer
toasted	tostado
covenant	alianza
quaff	beber a grandes tragos
centigrams	centígramos
incitements	incitamientos
poisoning	envenenando
typhus	el tifus
planetarium	planetario
chromatic	cromático (a)
magnate	potentado
so	de modo que
thanked	agradeció
toaster	tostadora ( toaster for bread)
accountability	responsabilidad
ladling	sirviendo con cucharones
teenager	adolescente
calendar	el calendario
intern	interno(a)
necessary	necesario
abominable	abominable
cesarian	cesárea
badminton	badminton
closet	el closet
abstained	abstinente
flower	la flor
single	solo
cement	cemento
teammate	compañero de equipo
witches	las brujas
abstainer	abstemio
closed	cerrado
to	para
censorship	censura
exhibitioner	exhibicionista; expositor
laborites	laboristas
chutzpah	personalidad
abominably	abominablemente
rules	reglas
ruler	la regla
biting	mordaz
transmissions	transmisiones
calculi	cálculos
ruled	reglado
up	arriba
fifteenth	quinzavo (part)
forgo	abstenerse de
this	esta
plasticity	plasticidad
chiropractor	médico quiropráctico 
thin	delgado ( person)
brake	freno
laboratories	laboratorios
quake	temblar
know	saber
workingmen	trabajadores
changed	cambió
snack	tomar un aperitivo
changes	cambios
apron	el delantal
acidification	acidificación
curfew	no tengo ni puta idea
we	nosotros
quail	acobardarse
daftest	el mas tonto
heir	heredero
grownups	gente grande
screw	tornillo
accessors	accesores
transfusions	transfusiones
teach	enseñar
zenith	cenit
reading	leyendo
argue	arguir
vacancies	vacantes
abductions	secuestros
bladder	vejiga
choir	coro
occupationally	ocupacionalmente
accessory	accesorio
bankrupt	bancarrota
talents	talentos
acknowledgment	reconocimiento
antenna	antena
machination	maquinación
held	tuvo lugar
exhibitionist	exhibicionista
exhibitionism	exhibicionismo
hell	infierno
helm	yelmo
internationalization	internaciionalización
terms	términos
tragicomedy	tragicomedia
capsules	cápsulas
laurel	el laurel
teams	equipos
nails	uñas
oaths	juramentos
centerpiece	centro de mesa
churches	las iglésias
antecedents	antecedentes
workingman	trabajador
readings	lecturas
ladybird	mariquita
fabric	fabrica
calcification	calcificación
adiabatic	adiabatica (curva)
centigrade	centígrado
circumcision	la circuncision
gravitate	gravitar
south	el sur
north	el norte
magnetism	magnetismo
tools	herramientas
baleful	funesto
labeling	marcando
sabotage	sabotaje
get	obtener
haggling	gerundióinf de haggle
barber	el barbero
precious	preciosa
machinating	maquinando
sell	vender
naturalism	natu
incanted	encantado(a)
abide	quedar(se)
brain	cerebro
transformation	transformación
help	ayudar
plutocrat	plutócrata
braid	trenza; galon(mil)
acceptation	aceptación
addresser	remitente
dress	el vestido
thru	atrávez
addresses	direcciones
earful	noticias
onion	la cebolla
obliged	obligado
harbor	puerto
treasures	tesoros
treasurer	tesorero
cardiogram	cardiograma
translate	traducir
fertilized	fertilizado
tariffs	tarifas
torpidly	torpemente
therapies	terápias
curious	curioso
incapacity	incapacidad
proud	orgulloso
transliterate	transliterar
rumbled	retumbado
brace	abrazadera
castigators	castigadores
stranded	desamparado
earthquake	el temblor
d%27etre	de ser
nightmare	la pesadilla
addressed	dirigido
addressee	destinatario
techniques	técnicas
treasured	atesorado
send	mandar
cauliflower	la coliflor
shrimp	camarone
challenges	desafíos
regret	sentir
scale	escala
thinkers	pensadores
magnetically	magneticamente
pacifistic	pacifista
gin	la ginebra
challenged	desafió ( action verb)
abstinence	abstinencia
iceberg	iceberg
station	estación
rabidly	rabiosamente
earning	ganancia
habitation	habitación
implementation	implantación
smoke	fumar
magical	mágico
treats	golosinas ( sweets )
daddy	papi
washing	lavando
humdrum	aburrido
harmless	inofensivo
celibacy	celibato
absorbingly	absorbentemente
anthem	motete(eccl); himno nacional
anther	antera
accouter	equipar
England	la inglaterra
without	sin
youth	juventud
abetting	instigando
habitations	habitaciones
mulberry	la mora
algebraically	algebraicamente
zeros	los ceros
seagulls	gaviotas
macrostructure	macroestructura
cellular	celular ( anglicism)
much	mucho
abiogenetically	abiogenéticamente
chapter	capítulo
tadpole	renacuajo
poise	aplomo
abortionists	abortistas
cerebellum	cerebellum
weekly	semanal
cider	la sidra
grenades	granadas
steelworker	acerero
plateaus	plataformas
incapacitate	incapacitar
tattooed	tatuado
salesclerk	dependiente
ruined	ruinado; bancarrotado
labial	labial
radiobroadcaster	transmitidor de radio
exiguity	exigüedad
wrap	envolver
yours	el tuyo
novel	la novela
badness	maldad
correct	correcto
lade	cargar (to load in shipping)
wack	dar un buen golpe a
reader	libro de lectura
adjectives	adjetivos.
torpid	torpe
chieftain	jéfe
callous	calloso
torte	torta ( pie)
telephotographic	telefotográficamente
murder	el asesinato
lace	la cinta
backgammon	chaquete
calcaneal	calcañal
internationally	internacionalmente
xylophones	xilófonos
lack	escasez
lagoons	lagunas
toast	la tostada
tails	colas
labs	los laboratorios
plastidial	plastidial
success	exito
laborable	laborable
sagaciously	sagazmente
young	joven
cabinetmakers	ebanister/ia
facilitation	facilitacion
gasoline	la gasolina
lubricated	lubricado
lipid	lípido
magnifically	magníficamente
caffeine	cafeína
forlorn	desamparado
fictionalize	novelizar
macerator	macerador
lubricates	lubrica
homeowners	dueños de casa
cabdriver	taxista
acidifier	que vuelve acído
acupuncture	acupuntura.
laborers	jornaleros
namesake	tocayo
acidity	acidez
tonalities	tonalidades
lads	chicos
transmissibility	transmisibidad
lady	dama
ulcer	ulcera
magazine	what happened? i just wanted to erase "almacén"![conjunction]
wade	chapotear
amassed	amontado
pocket	el bolsillo
chronologist	cronólogo
cannibalism	canibalismo
reabsorption	reabsorción
maculate	manchar
macerated	macerado
channel	canal
ladyfinger	lengua de gato (biscuit)
changing	cambiando
cascades	cascadas
mule	la mula
tetanus	tétano
camel	camello
macerates	macera
seaquake	maremoto
write	escribir
wage	sueldo
fiber	fibra
passengers	pasajeros
taffeta	tafeta
musical	musical
understand	entender
abysmal	abismal
eardrum	tambor auditivo
waft	soplo de viento
gynecology	ginecología
unhappy	infeliz
winner	el ganador
strongly	fuertemente
bull	el toro
champion	campeón
wait	esperar
circuit	el circuito
American	americano
objurgated	reprendido
queen	la reina
artefact	artefacto
gut	intestino
guy	tío (inf: hombre)
lagger	vago
calcareous	calcáreo
wail	lamento
debit	debit
documentary	documental
tempted	tentó
accordingly	por consiguiente; en consecuencia
laid	acostado
gymnasiums	gimnasios
lair	la guarida
pacific	pacifico
names	michael
abominations	abominaciones
taeniasis	infecci'on con tenia (gusano plano)
laic	laico
chronicle	crónica
dicker	vergante
tide	marea ( as in weather )
tonight	ésta noche
tabloid	escenario
acetone	acetona
bacteria	bacteria
threefold	tres veces
almost	casi
traitorize	traicionar
look at	mirar
harmful	dañino
calash	calesa
capacitate	capacitar
hacking	hacking
ice cream	el helado
eardrop	gota para oreja
earlier	mas temprano
charity	caridad
sadomasochist	sadomasoquista
sadomasochism	sadomasoquismo
wafers	los barquillos
lagged	retrasado
swan	cisne
objet	objeto
reconcile	reconciliar
contentions	disputas
abolitionary	abolicionista
arms	los brazos
gym	gimnasio; gimnasia
cartel	cartel
lake	lago
nuance	matiz
abdomen	(inf.)barriga
bush	el arbusto
policies	políticas
accidentally	por accidente
sacrificed	sacrificado
ties	corbatas ( as in dress tie )
catastrophe	catástrofe
busy	ocupado
land	la tierra
chronologize	cronologizár
cholera	cólera ( disease)
identic	idéntico
idealized	idealizado
sacrifices	dewayne
burn	quemar
sacrificer	quien realiza sacrificios
tithes	diezmos
lamp	la lámpara
backfire	petardeo
idealizes	idealiza
lamb	el cordero
lama	lama (monje)
wall	pared (a dentro)
extending	extendiendo
walk	andar
sacrilegious	sacrilego
nipple	pezon
absconds	ocultarse
macerate	macerar
marry	casarse
casinos	casinos
acorn	bellota
incidental	incidental
abomasal	del cuarto estómago
chanteuse	cantante ( singer m or f )
camaraderie	camaradería
thinks	piensa
accentless	sin acento
welcome	grato
televisual	televisual
chaos	chaos
abundant	abundante
centenarian	centenario
earns	gana
want	querir
almond	la almendra
forecast	pronosticar
mute	mudo
steaks	things
uncover	descubrir
radiantly	brillantemente
baffle	confundir
backwoods	bosque
circle	el círculo
bagpipe	la gaita
nystagmus	nova
aluminum	el aluminio
chase	perseguir
accident	(automobile) choque
colors	los colores
found	fundir (to melt or cast eg. to found the steel bars together)
knight	caballero
canal	canal
inclement	inclemente
fiancee	prometida
ideals	ideales
fanatics	los fanaticos
intimate	íntimo
plasmalemma	plasmalema
narcotics	narcóticos
charm	echizar
tragedy	tragedia
antagonize	enemistarse con;
antagonism	antagonismo
attend	asistir
macromolecular	macromolecular
shovel	pala
had	pretéritóparticipio pasado de have
accounting	contabilidad
secure	seguro
antagonist	antagonista
sabotaging	saboteando
wasp	avispa
late	tarde
ham	jamon
school	la escuela
locomotive	la locomotora
ruinations	ruinaciones
things	cosas
tile	mosaico
avenue	la avenida
hat	el sombrero
abounds	abunda
champ	campéon
brush	el cepillo
facsimile	facsimile
last	durar
radiobiology	radiobiologia
trapped	atrapado
weighs	pondera
yellowed	amarilló
adapt	adaptar(se)
headlights	linternas delanteras
lass	la muchacha
wash	lavar
weight	la pesa
odors	olores
warm	caliente
transcendence	trascendencia
carelessly	sin cuidado
chalk	yeso
castrate	castrar
swim	nadar
abiogenetic	abiogenético
macrocephaly	macrocefalia
plural	plural
toads	batracios
disrupted	transtornado
impossible	imposible
tins	latas
tint	teñir ( to tint)
wave	ola (de agua)
yesterday	ayer
acquirement	adquisición
ecology	ecologia
quadriceps	cuadriceps
cocktail	coctail
pajama	pijama
cabinetwork	ebanistería
early	temprano
chocolates	chocolates
radioastronomy	radioastronómico
yen	yen
incitement	incitamiento
loathe	aborrecer
yes	si
temerity	temor
yet	aún
yew	tejo
childless	sin descendéncia
tediously	tediosamente
raccoons	mapache
cafeterias	cafeterías
wager	la apuesta
wages	pagópagásueldo
eatery	el comedor
laud	loor
time	hora
odometers	odometros
accusatory	acusatorióa
happy	feliz
macarize	macarron
pneumatically	neumáticamente
tips	propinas ( gratuities ) consejos ( advice)
hen	la gallina
racehorses	caballos de carreras
abrogating	abrrogante
carbon	carbón
circus	el circo
granddad	abuelo
backwaters	remansos
zounds	cáspita
torpedo	torpedo
laws	las leyes
labile	lábil
lesson	la lección
magnesium	magnesio
bedrooms	el dormitorios
addictions	adicciones.
palaces	palacios
passenger	el pasajero
terrific	magnífico
tiny	pequeño
abaxial	abaxial
acidify	volver acído
lawn	el cesped
baskets	las cestas
stubborn	terco
macroaggregated	macroagregado
lazy	guapo
comediennes	cómicas
brakeless	sin freno
tourism	turismo
tablespoonful	cucharada
alien	extranjero
smart	majo
triangle	triángulo
tourist	turista
tomatoes	tomates
smash	golpear
incidences	incidencias
tire	llanta(car tire)cansar(to tire)
ledger	travesaño
chain	la cadena
torso	torso
chair	silla
tennis	ténis
enzymologist	enzimólogo
earnings	ganancias
accompanist	acompanista
ideate	idear
chat	charlar
accelerometers	acelerímetros
garden	el jardín
academicianship	academicismo
omnipotence	omnipotencia
small	small
beam	haz de luz
tits	tetas ( as in breasts 
dichroic	dicroico
before	antes
fiction	ficción
torticollis	tortículis
bead	perla
perspire	sudar
him	el
hip	la cadera
temptations	tentaciones
hit	pegar
tetanic	tetánico(a)
bear	el oso
grandfather	el abuelo
bean	haba
hagiographies	hagiografías
incarnate	encarnar
straighten	enderezarse [intransitive]
history	la historia
careless	sin cuidado
square	plaza
toothpick	modadiente 
camps	campamentos
hagiography	hagiografía
pneumatics	neumática
zebras	cebras
dairies	diarios
eared	en mazorca
steals	takes
textbooks	manuales
point	punto
dafter	mas tonto
habituates	(se) habitua
carcinogenic	carcinogénico
hospital	el hospital
abler	(comparativo) más capaz/hábil
ceiling	techo
habituated	habituado
fugitive	fugitivo
chef	cocinero
crowded	atestado
alibi	coartada
chickpea	garbanzo
meal	la comida
calisthenics	calistenia
meat	la carne
chew	masticar
abrogation	abrogacíon
attendance	asistencia
radioactive	radioactivo
abbe	abbé=abate
alphabet	el alfabeto
meek	paciente
advance	avance
attendants	asistentes
chic	chic
appreciate	apreciar
yon	ahí allí
killer	asasino
beer	la cerveza
you	vosotros(plural/informal)
limitations	las limitaciones
chlorides	clorúros
incant	encantar
active	activo(a)
plumbiferous	plumbífero
lacked	faltaba
earphone	audífono
agile	ágil
beds	las camas
mirror	el espejo
gardens	jardines
shiver	tiritar
lacerated	lacerado
abuses	abusa
hot	caliente
liquor	el licor
abuser	abusador
characteristic	característica
calms	calma
lubricate	lubricar
lacerates	lacera
calla	aro palustre
chin	la barbilla
testosterone	testósterona
cargoes	cargas
accompanists	acompanistas
answer	la respuesta
meet	ser presentado a
calls	llamadas
seashore	costa del mar
timidity	timidez
ablative	ablativo
saints	santos
quadroon	cuarterón
aging	envejecimiento
abused	maltratado
celebrity	célebre
Monday	el lunes
inborn	innato(a)
sometimes	a veces
promise	prometer
easter	la pasqua
dandelion	diente de leon
reply	contestar
lightening	el relámpago
zeroes	los ceros
storybook	el libro de cuentos
count	contar
cheapskates	tacaños
gymnastic	gimnasia
lucratively	lucrativamente
transgressions	pecados ( sins )
abed	en cama
cadences	cadencias
calfs	pantorrillas
abet	instigar
carrying	cargando
tetanizing	tetanización
seabird	ave marina
beginning	el principio
plutocratically	plutocráticamente
fudge	dulce de chocolate
acaulescent	acaule
abnormalize	anormalizar
harlequinade	arlequinada
absolving	absolver
topcoats	sobreabrigos
notice	prestar atención
grandson	el nieto
killed	matado
chloroform	clorofórmo
daftly	locamente
plebiscite	plebiscito
aberrancy	error
although	aunque
icicle	el carámbano
president	el presidente
aberrance	equivocación
muscular	muscular
basket	la cesta
aberrational	aberrante; desviado
envy	envidiar
therein	adjunto
kitten	el gatito
alphabetic	english
translations	traducciones
actualizes	actualiza
action	acción
singlehanded	sin ayuda
accompanies	acompaña
macarizes	macarrona
actualized	actualizado
macarized	macarronismo
bell	la campana
readouts	indicaciones
accompanied	acompanado
abecedarian	abecedario
suburbs	las afueras
ably	hábilmente
acanthus	acanto
deliver	entregar
eight	ocho
products	productos
zephyr	céfiro
barbecue	barbacoa
overpriced	sobrevalorado
accredit	acreditar
can't	no puede
faucet	el grifo
abstracts	abstractos
topics	temas
strike	huelga
torch	antorcha
incinerated	incinerado
hamburgers	hamburgesas
radar	radar
able	hábil (skilled)
incinerates	incinera
cheaper	más barato
radii	radios (pl. of radius=radio)
accommodating	alojando
banquet	banquete
taskwork	quehaceres ( chores)
cough	toser
ballade	balada
radio	la radio
exiguously	exiguamente
chickpeas	garbanzos
accelerate	acelerar
ballads	baladas
international	internacional
calculated	calculado
arterialize	arterializar
plasmolytically	plasmolíticamente
filial	filial
accepts	aceptar
exhortations	exhortaciones
mailboxes	buzones
dentist	el dentista
friends	los amigos
forget	olvidarse
quadripartite	cuatripartita
tardily	tardemente
accolades	acoladas
curtain	la cortina
enzymically	enzimaticamente
trapezist	trapecista
accommodations	alojamientos
transgression	pecado (sin)transgresión
best	el mejor
movements	los movimientos
transform	transformar
quaintness	carácter pintoresco
magnitude	magnitud
certainly	ciertamente
rooster	el gallo
impressive	impresionante
adenomatous	adenomatoso
calculates	calcula
accommodation	alojamiento
backtracking	desandando
landlords	los dueños
lubricant	lubricante
ballerinas	bailarinas
annoy	enojar
charcuterie	cuchillería ( knives )
tetanization	tetanización
cover	la cubierta
traffickers	traficantes
cheapie	tacaño
thereat	allá
torpidity	torpidez
absenting	ausentando
pointer	puntero
backdrop	telon
something	algo
vitamin	la vitamina
incinerator	incinerador
pointed	puntiagudo
traitors	traidores
rude	rudo
wafer	galleta
cheekbone	pómulo
abstractionism	abstraccionismo
understandable	comprensible
celebrants	festejantes
chickenhearted	cobárde
shower	la ducha
nevertheless	no obstante
sabbath	sábado
fact	realidad
surfboard	tabla de surf
racquet	raqueta
temperature	temperatura
rugs	tapetes
tactician	t'actico
free	gratis
galaxy	galaxia
babes	niños
softwares	programas
airplanes	los aviones
raindrop	la gota de lluvia
face	rostro
abiogenesis	abiogénesis
narcissistic	narcisista
afraid	to be afraid - tener miedo
cessation	cese
invite	invitar
countable	contable
calculation	cálculo
helpers	ayudantes
habitual	acostumbrado
ice	el hielo
capriccio	capricho
playable	pagable
whenever	cada vez que
ruin	ruina; bancarrota
commands	órdenes
vanilla	la vainilla
keeper	guardián
please	por favor
abut	terminar
acclimatizable	aclimatable
laboratory	laboratorio
pluggable	enchufable
disadvantageous	desventajado
exhorts	exhortos
macrostructural	macroestructural
rule	la regla
amateur	novicio
palazzos	palacios
resentment	resentimiento
poem	el poema
damaging	dañando
littler	menor
poet	el poeta
sneeze	estornudar
shave	afeitar
blinds	persianas
characteristics	características
lucidity	lucidez
certainty	certidumbre
theology	teología
icons	iconos
guitar	la guitarra
raindrops	las gotas de lluvia
transcend	trascender
ablating	extirpando
tingle	erizar (to tingle)
fair	justo
tolerating	tolerando
charitable	caritativo
occidental	occidental
safety	seguridad
dresses	los vestidos
calculator	calculadora
calcaneus	calcáneo
ablation	ablación
doors	las puertas
daguerreotype	daguerrotipo
chastised	castigó
breakfast	el desayuno
steel	el acero
nipples	pezones
seize	agarrar
church	la iglesia
fabulously	fabulosamente
affectionate	carinoso
foreign	extranjero
polices	políticas
fall	caer
abortifacient	abortivo
daguerreotypy	daguerrotipia
polarization	polarización
calcaneum	calcáneo
erase	borrar
interneuronal	interneuronal
stereophony	estereofonia
abstract	resumen
cadaveric	cadavérico
nice	amable
gutter	cuneta (en la calle); canalón (tejado); gotera; arroyo
paints	pinturas
interneuron	neuron interno
fisherman	el pescador
first	primero
desserts	postres
nuances	matices
perfect	perfecto
docile	dócil
fewer	menos
pole	polo
seacoast	costa del mar
mortally	mortalmente
centavo	centavo
frog	la rana
theater	teatro
harmed	dañado
nephew	el sobrino
abusers	abusadores
from	de
lager	cerveza dorada
dagger	daga
accordion	acordeón
habilitations	habilitaciones
yeoman	hacendado
incalculable	incalculable
daffy	chiflado; loco
candelabra	candelabro
doctorate	doctornado
exhortatory	exhortatorio
incalculably	incalculable
fame	la fama
lackey	lacayo (sirviente)
pond	el estanque
repair	reparar
death	la muerte
steak	meat
ashtray	el cenicero
steal	take
advice	el consejo
according	de acuerdo con
powder	el polvo
rust	el moho
tetanized	tetanizádo
attendant	asistente
paper	el papel
steam	el vapor
zoo	jardín zoológico
pneumatolysis	neumatolisis
guts	intestinos
tetanizes	tetaníza
tetrafluoride	tetrafluóruro
liberalism	el liberalismo
quantity	la cantidad
obliquity	oblicuidad
acolytes	acólitos
ink	la tinta
teaspoonsful	cucharaditas
threaded	hilvanar
carrot	la zanahoria
pope	el papa
bicycle	la bicicleta
cicadas	la cigarra
objector	objetor
objects	objetos
plebiscitary	plebiscitario
braggart	fanfarron; jactancioso
absorbancy	absorbencia
spouse	esposo
calcination	calcinación
acuity	n agudeza; visual _____ agudeza visual
poop	caca
poor	pobre
farm	la hacienda
acetaldehyde	acetaldehido
habitant	habitante
tentacles	tentáculos
lenses	lentes
excellent	excelente
pool	la piscina
adapted	adaptado
achievers	personas que logran sus metas
acrobatics	acrobacias
airport	el aeropuerto
harangue	arengar
municipal	municipal
cigarettes	los cigarros (mex)
charged	cargado
feign	aparentar
titular	titular
chapters	capítulos
acidulate	acidular
sealskin	piel de foca
adenoidal	adenoidal
pacifism	pacifismo
vocabulary	el vocabulario
vegetarian	vegetariano
aggressive	agresivo
pacifist	pacifista
close	cerrar
chemistry	química
winners	los ganadores
odorless	inoloro
accelerated	acelerado
embarrassment	desconcierto
oblige	obligar
actresses	actrices
handbag	la bolsa
fast	(adv.) de prosa rápidamente
trials	juicios
magistrates	magistrados
accelerates	acelera
nine	nueve
absentmindedly	distraidamente
blonde	rubio
acclaim	aplaudir
fortunately	afortunadamente
acid	ácido
packagings	empaquetados
scuba diving	buceo
jackpot	premio máximo
exhibitors	expositores
tiresome	cansón
lubric	lúbrico
abducens	separador
abducent	separador
accede	aceder
capuchin	cachupín
abstemious	abstemio
article	artículo
respect	respetar
shelf	el estante
touristic	turítico
castigation	castigo
ache	dolor
carnivore	carnívoro
aardvark	cerdo hormiguero
abbreviator	abreviador
adjustment	n -  ajuste -m; correccion -f  (accent over the  o); modificacion -f (accent over the o)
ankles	los tobillos
adjustable	adj - ajustable
blackboard	la pizarra
jabber	algarabía
smallest	menor
fucker	chingador
choose	escojer ( to choose)
aborigine	aborigen
cabbie	el taxista
jeans	vaqueros
abusively	abusivamente
ticklish	cosquilloso
mixture	la mezcla
butterfish	mariposa
hares	liebres
abstention	abstención
wadding	relleno
cigars	los puros
harem	harém
carpentry	carpintería
harebrained	tonto
acidulant	acidulante
tarantula	tarantula
chickadees	bohíos
madly	locamente
fucked	chingado
absolutes	absolutos
college	el colegio
oceanfront	costa
backup	respaldo
paganization	paganizacion
tetanically	tetánicamente
toothaches	dolores de muela
abeyant	en suspenso
adaptively	adaptativamente
obedience	obediencia
punish	castigar
casual	informal
centers	centros
dailies	diarios
calcined	calcinado
harmonica	armónica (inst.mús.)
tongueless	sin lengua
weeps	llora
nothing	nada
testing	probándo
animation	animación
yellows	amarillos
silver	la plata
lukewarm	tibio
mortgages	hipotecas
mortgager	hipotecario
tablespoonfuls	cucharadas
chronometric	cronométrico (a)
city	la ciudad
obligational	obligatorio
torments	tormentos
local	local
narrational	narrativo
yield	producir
mortgaged	hipotecado
incidentally	incidentalmente
polar	polar
caducean	caduco
tributes	tributos
acne	acné
carcinoma	carcinoma
ablutionary	ablucionario
objected	objetado
acquaintance	conocidóda
cheeseburger	hamburquesa de queso
tabulator	tabulador
smashed	golpeado
radioautograph	radioautografo
absorbed	absorto
points	puntos
radiolysis	radiolosis
abradant	abrasivo
absorber	absorber
pregnant	embarasada (really)
read	leer
telegrams	telegramas
backhanded	ambiguo
fictional	novelesco
touch	tocar
admission	n - (to the hospital) adnision -f (accent over the   o); ingreso
clock	el reloj
real	verdadero
abetter	instigador
quadrangle	cuadrángulo 
sacraments	sacramentos
April	abril
adaptable	adaptable
tattoos	tatuajes
activations	activaciones
abetted	ayud/o
badly	malamente
facilitate	facilitar
theologians	teólogos
habituation	habituación
tranquilness	tranquilidad
abbreviates	reducciones
stereochemists	estereoquimicos
accelerometer	acelerímetro
today	hoy
predict	predecir
saying	dicho
metalize	shgfhg
fifteen	quince
radical	radical
labyrinths	laberintos
minute	el minuto
transcendent	trascendiente
application	aplicacion
hummingbird	colibrí
kilometers	kilómetros
acre	acre
abbreviated	cortado
zoology	la zoología
ferment	fermento
acclimatizes	aclimatiza
acclimatizer	climatizador
comforting	confortante
ship	nave
jab	pinchazo
abashed	avergonzado
jag	raja
cupulate	copular
identification	identificación
annual	anual
jar	la jarra
wails	lamento(a)
testify	testificar
get up	levantarse
abashes	avergüenza
tarnish	manchar ( to stain)
mortals	mortales
spheres	esferos
turkey	el pavo
letter	(of the alphabet) la letra
telescope	telescopio
anniversaries	aniversarios
habituating	habituando
moustaches	los bigotes
abrogates	abrroga
odontology	odontologia
accuse	acusar
accentuate	acentuar
frequently	a menudo
devil	el diablo
poisons	venenos
incendiaries	incendiarios(as)
acquire	adquirir
ligament	el ligamento
tactic	táctica
fertile	fértil
notion	noción
malleability	maleabilidad
taken	tomado
tarnished	manchado ( stained)
abstruse	abstruso
popular	popular
cavities	caries
broken	roto
testimonializer	uno que da testimónio
acclivity	cuesta
obfuscate	ofuscar
telephoto	telefoto
lacking	faltar (something is lacking/algo falta)
ablated	extirpado
abattoir	matadero (gb)
lakefront	en la orilla del lago
wrinkle	la arruga
abrogated	abrrogado
incautious	descuidado(a)
calendars	calendarios
olives	aceitunas
shit	mierda
fulsome	de mal gusto
fabulous	fabuloso
plethoric	pletórico
castle	el castillo
challenging	desafiando
debate	debate
preach	sermonear
helpful	útil
plasmatic	plasmático
those	aquellos
worry	preocuparse
rafts	babas
telephone	teléfono
chessboard	tabla de ajedrez
bleed	sangrar
delicious	delicioso
worse	peor
catalogue	catálogo
difficulty	dificultad
telephony	telefonía
thunderstorm	la tronada
boyish	muchachil
boycotted	boicoteado
calligraphy	caligrafía
whiskey	el whiskey
shop	tienda
abstain	absternerse
show	mostrar
arrive	llegar
chimps	chimpancés
street	la calle
feverish	febríl
plains	llanos
diocese	diócesis
seamen	marineros
shoe	zapato
managerially	gerencialmente
tonsil	amígdalas
incestuous	incestuoso(a)
tachometer	tacómetro
cardiograms	cardiogramas
suddenly	de repente
acclimatized	climatizado
christened	bautizádo (a)
stereoisomeric	estereoisomerico
earnestness	seriedad
nervous	nervioso
octagon	octágono
chastisements	castigos
absorbing	absorbente
abettor	instigador
stranger	forastero
acclimatization	aclimatación
stairway	la escalera
tactless	torpe
delicate	delicado
aborted	abortado
cherub	querubín
tissue	tejido
rent	el alquiler
carpenter	el carpintero
aborter	abortante
frost	la escarcha
incline	inclinar
feint	finta
circuits	los circuitos
habitants	habitantes
accelerator	acelerador
poesies	poesías
calculable	calculable
chained	encadenado
macrocosmic	macrocosmico
hackling	happy birthday
hardness	dureza
tenacious	tenaz
omen	agüero
habilitate	habilitar
calculably	calculablemente
waist	cintura
acyclically	acíclicamente
cherry	la cereza
lagers	cervezas doradas
bottles	las botellas
lollipop	el pirulí
babies	criaturas
madam	dama
seaman	marinero
plateau	plataforma 
comrade	amigo
maneuverer	maniobrador
babied	mimado (a)
stress	el estrés
chandelier	candelabro
synagog	sinagoga
polarizable	polarizable
accessary	accesorio
babushka	la babushka (sombrero ruso)
headdress	tocado
tribes	tribús
acrobat	acróbata
calends	calendas
addictive	que crea hábito
accelerators	aceleradores
transsexualism	transexualismo
dairy	producto lácteo
shut	cerrar
luck	suerte
cabstand	parada de taxis
fielder	jardinero
abatements	s. descuento
cloud	la nube
magnolia	magnolia
amicably	amistablemente
exigence	exigencia
rainbows	los arcoirises
acerbate	acerbar
pleura	pleura
totally	totalmente
testicular	testicular
addiction	adicción.
exigent	exigente
forgives	perdona
important	importante
additives	aditivos
radioautography	radioautografía
bones	los huesos
daily	todos los dias
abnormality	anormalidad
exigency	exigencia
eaten	comido
job	trabajo
daughter	nina
omit	omitir
cloth	la tela
babbles	balbucea
babbler	balbuceador
limitation	la limitación
terrify	terroriza
polemical	polémico
preambles	preámbulos
captain	capitán
footing	andar ( como deporte )
tormenters	atormentadores
adjective	el adjetivo
car window	la ventanilla
translators	traductores
babbled	balbuceado
clown	el payaso
fugue	fuga
sheep	la oveja
rest	descansar
teleprompter	teleprómpter
nectar	nectar
kingdom	reino
afternoon	la tarde
front	el frente
flights	vuelos
timothy	timoteo
stupid	menso
canoe	canoa
asterisk	el asterisco
wedge	cuña
testicle	testículo
treatments	tratamientos
canon	canonizar ( to canonize )
maces	mazas
offer	ofrecer
pluripotent	pluripotente
thawed	descongelado 
campaigns	campañas
abortively	abortivamente
humidity	la humedad
thanklessly	malagradecidamnete
accurately	precisión
plastic	plático
tequila	tequila
plastid	plasto
drive	manejar
teeter	tambalear 
amenities	amenidades
traits	características
dichromatism	dicromatismo
dainty	poquita
abasement	humillación
fervid	vehemente
earring	el aro
sailor	el marinero
where're	donde esta?
bacterially	bacterianamente
national	nacional
radiolytic	radiolítico
lactase	lactasa
laconisms	laconismos
tackier	pegajoso
sixty	sesenta
medicine	la medicina
taffies	caramelos (de az'ucar fundida)
applicant	solicitante
abradable	abrasible
accidentalness	accidentalmente
gynecological	ginecológicóa
lactate	lactar
windshield	el parabrisa (se usa en los eeuu)
spider	arana
transliteration	transliteración
testimonial	testimonio
widower	viudo
rooms	salas
curricular	circular
inciting	incitante
contact	ponerse en contacto
saboteur	saboteador
munch	masticar
synarthrosis	sinartrosis
tires	llantas ( car tires)
disadvantage	desventaja
champions	campeones
plasm	plasma
daggerman	dagador
bacilli	bacilos
garbage	la basura
achromatically	acromáticamente
cereals	cereales
adjust	vt - ajustar
macroeconomic	macroeconomico
macho	macho
party	la tertulia
accountants	contables
cataloged	catalogado
trained	adiestrado ( military)
trembling	tempando
salute	saludar
traumatic	traumatico
candid	cándido
trainer	adiestrador ( military)
laird	terrateniente
occultist	ocultista
false	falso
weasel	comadreja
occultism	ocultismo
trajectory	trayectoria
radiometer	radiometro
sayings	dichos
capitols	capitolios
farmer	el campesino
caduceus	caduceo
bailee	depositario
fulfill	cumplir
crowd	muchedumbre
laity	seglares
sick	enfermo
bailer	fiador
talons	talones
there'd	habría
maiden	soltera
torrential	torrencioso
costume	disfrás
placebo	placebo
crown	corona
sentence	la frase
hallway	el pasillo
cabala	cábala
accents	accentos
vain	vano
tiara	tiara
ordinary	ordinario
youngster	jovencito
filament	filamento
drink	el refresco
toted	portó ( carried )
aftertaste	sabor  -m
economize	economisár
stereo	estereo
firearm	arma de fuego
theocratic	teocrático
hello	que tal
bactericidal	bactericida
testimonies	testimonios
bacterium	bacteria
plate	el plato
tournament	campeonato
thinking	pensando
mademoiselles	señoritas
leech	sanguijuela
world	el mundo
everything	todo
fanatic	el fanatico
there'll	habrá
bread	el pan
side	el lado
break	romper
restaurant	el restaurante
tabular	tabular
radiography	radiografía
comfort	comodidad
dictatorship	dictadura
joke	la broma
frequented	adj. asendereado
bacon	el tocino
century	siglo
traditionally	tradicionalmente
candle	vela
married	casado
auto	el auto
sacristan	sacristan
lucre	lucro
knees	rodillas
sign	firmar
download	bajar
high	alto
tasteful	gustoso
champagne	champaña
transgressed	pecó ( sinned)
different	diferente
administrators	administradores
kneel	arrodillarse
absurdities	disparates (plural)
grenade	granada
level	el nivel
Europe	la europa
poker	hurgón
chieftaincy	jefatúra
magnanimous	magnánimo
chats	charlas
calcining	calcinando
birthday	cumpleaños
balustrade	barandilla
tastes	gustos
obbligato	obligado
taster	gustador
candy	el dulce
ablutions	abluciones
recipe	la receta
drugstore	la farmacia
tasted	gustó
total	suma
niece	la sobrina
disrupting	transtornando
canes	bastones
zebra	cebra
macro	macro
cabana	cabanã
exhibitor	expositor
clockwise	en el sentido de las agujas del reloj
interesting	interesante
incestuousness	incestuosidad
incitants	incitantes
lemons	limones
acknowledge	reconocer
lobby	el vestíbulo
earth	tierra
backs	espaldas
preamble	preámbulo
elbow	el codo
factitious	facticio
grandmothers	abuelas
threatening	amenazando
ledge	borde
transgress	pecar ( to sin)
mancipation	emancipación
objective	objetivo
backbones	espinazos
gynecologists	ginecólogos/as
accomplishments	triunfos
inclinations	inclinaciones
exhibit	exhibir
footpath	sendero
pleurae	pleuras
napalm	napalm
ablest	(comparativo) el más capaz/hábil
accept	aceptar
zigzag	zigzag
badge	banda
yearning	anhelo
abominators	abominadores
accretions	aumentos
pleural	pleural
scrambled	revuelto
cabinetmaking	ebanister/ia
painless	indolorósin dolor
access	acceso
tachygraphical	tquigráfica
allspice	malagueta
teens	adolescentes
ragman	trapero
bookstore	la tienda de libros
cactus	el cacto
plutocracy	plutocracia
macarizing	macarronico
key	llave
surprised	sorprendido
silk	la seda
addicted	(to become addicted) enviciarse volverse adicto
acuminate	acuminado
loads	las cargas
abutilon	abutilon
raisin	la pasa de uva
flagellantism	flagelantismo
hill	la loma
footballer	futbolista
cricket	grillo
tightly	apretadamente
mortality	mortalidad
caudillo	caudillo
fourth	el cuarto
laughing	riendo
tamale	tamal
pluses	añadidos
anteater	oso hormiguero
pocketknife	navaja
radiometry	radiometría
abjuring	abjurando; abjuración
abdomens	abdómenes
athlete	el atleta
rainstorm	el tormento de lluvia
thanklessness	malagradecimiento
calibrator	calibrador
accountancy	contabilidad
carpet	la alfombra
sing	cantar
abscission	abscisión
cabanas	cabañas
ruinate	destruir; ruinar
donkey	el burro
figured	figurado
docket	sumario
helices	hélice
commemorate	conmemorar
transmit	transmitir
camphor	alcánfor
abasing	humillando
technology	tecnología
laundryman	el lavadero
leaflet	el librito
squanderer	despilfarrador
backed	respaldado
reach	alcanzar
childish	bóbo (a)
calibrated	calibrado
torpedoes	torpedos
calibers	calibre
squandered	malgastado
backer	respaldador
rulers	gobernantes
teeth	dientes
tighten	apretar
between	entre
exhibited	exhibido
raspberry	la frambuesa
collar	el cuello
banker	el banquero
lettuce	la lechuga
lanterns	las lámparas
topographic	topográfico
dahlia	dalia
cablegrams	cablegramas
pacifically	pacíficamente
notifications	notificaciones
topographer	topógrafo
balustrades	barandillas
habitats	hábitats
announcing	estar anunciando
blocked	bloqueado
poliomyelitis	poliomelitis
d'oeuvre	obra maestra (chef d'oeuvre)
abolishment	abolicíon
abolishable	suprimible
leap	el salto
place	el lugar
grandfathers	abuelos
lawless	sin ley
regular	regular
objection	objeción
carefree	sin cuidado
tired	cansado
tremble	temblar
aggression	agresión
leaf	la hoja
lead	el plomo
balsamic	balsámico (a)
pacification	pacificación
daggers	dagas
acellular	acelular
haddock	eglefino (pescado)
macrodynamic	macrodinamica
adequate	adj - adecuado
cherries	cerezas
transferable	transferible
abortions	abortos
sausage	salchicha
pluralizers	pluralizadores
barbarization	barbarización
plain	plano
only	solamente
cadency	cadencia
obesity	obesidad
chrysanthemums	crisántemos
cheekbones	pómulos
accepted	aceptado
cadence	cadencia ( musical)
informant	informante
blueprint	anteproyecto
person	la persona
testimony	testimonio
accepter	aceptor
labiodental	labiodental
duende	duende
calligraphist	calígrafo
week	semana
acknowledged	reconocido
ferocious	feroz
balloons	globos
musicians	los músicos
preaching	sermón
objurgate	reprender
weep	llorar
tragicomical	tragicómico
readjust	reajustar
ready	propenso
acknowledger	persona que reconoce
absorbance	absorvencia
pacifier	pacificador
balloon	globo
haddocks	eglefinos (pescados)
limited	limitado
earthworm	gusano
macaw	lapa
reads	lee
accent	el acento
pacifies	pacifica
ladles	cuchorones
laundress	la lavadera
calibrates	calibra
tortoises	jicoteas
prepare	preparar
fifty	cincuenta
tinkle	orinar ( to urinate)
surgeon	el cirujano
abbreviating	abreviando
wake up	despertarse
earthworms	gusanos
postman	cartero(a)
legs	las piernas
rabbit	el conejo
oceanic	oceanico
abolishers	abolicionistas
transmittable	transmisible
calcify	calcificar
seabed	lecho marino
carnival	carnaval
circular	circular
yourselves	ustedes mismos
backbite	difamar
backwards	hacia atrás
left	izquierdo
temper	genio
tormentor	atormentador
arteriole	arteriola; pequena arteria
eleven	once
talisman	talismán
accessibly	accesiblemente
tickle	hacer cosquillas
cardiac	cardíaco
object	el objeto
accessible	accesible
destroyer	destruidor
balanced	equilibrado (a)
habitability	habitabilidad
example	el ejemplo
characters	carácteres
ermine	armiño
plasmolysis	plasmólisis
multiplication	la multiplicación
quiet	quieto
raids	incursiones
teaspoonfuls	cucharaditas
policy	política
address	domicilio
absentia	ausencia
rabble	canalla
accessories	accesorios
abbreviation	abreviatura
accumulates	acumuladóa
obeying	obedeciendo
towed	remolcado 
destroyed	destruido
police	policía
throw	tirar
stature	altura
fifth	quinto
thank	dar gracias
accumulated	acumulado
acknowledgement	reconocimiento
acknowledgeable	reconocible
backaches	dolores de espalda
torturing	torturando
thefts	hurtos
thousandfold	mil veces
trembly	tembloroso
haciendas	haciendas
choirboy	corista
implement	implantar
oeuvres	obras
headlight	linterna delantera
salutations	saludos
incinerate	incinerar
sagacious	sagaz
check	cheque
beacon	atalaya
torsion	torsión
incision	incisión
actualization	actualización.
grandparent	abuelo
translating	traduciendo
tasteless	sin gusto
macaws	lapas
absolutizes	absolutiza
earthquakes	los terremotos
chefs	cocineros
society	sociedad
bacterial	bacteriano
treasurership	tesorería
romantic	romantico
patiently	pacientemente
workbenches	mesas de trabajo
lend	prestar
November	noviembre
cablegram	cablegrama
pilot	el piloto
ticket	tiqué ( theater)
acceptor	aceptador
cheek	mejilla
cartilage	cartílago
magnet	imán
weld	soldar
absently	en ausencia
translation	traducción
well	bien
personnel	personal
incenses	inciensa
oaken	de roble
pocketbooks	libros de bolsillo
incensed	inciensado(a)
rainy	lluvioso
flour	la harina
fierce	feroz
earflap	oreja
dahlias	dalias
flagpole	asta
odorous	oloroso
tangerine	la mandarina
byte	el byte
macintosh	macintosh
rains	las lluvias
destine	destinar
mutation	la mutación
crazy	loco
razor	la navaja
managers	gerentes
knockdown	tumbar
tabloids	escenarios
fuck	chingar
talcum	talco
carousel	carusel
tormenter	atormentador
bandage	la venda
rails	las vías
noise	el ruido
contented	satisfecho
occupational	ocupacional
lover	amante
vinegar	el vinagre
cadastral	catastral
ballistic	balístico (a)
cheap	barato
dictators	dictadores
thanksgiving	acción de gracias
witch	la bruja
tormented	atormentado
incitations	incitaciones
backslide	reincidir
capital	la capital
traveler	viajante
exhibiting	exhibiendo; exhibir
fuel	combustible
celestial	celestial
translated	traducido
employee	el empleado
lad	chico
pray	rogar
lac	laca
platforms	plataformas
identical	idéntico
abject	miserable (poverty); rastrero (apology)
helicopters	helicópteros
lag	atrasarse
contemptuous	desdeñoso
towel	toalla
raise	(a child or animal) criar
spoon	la cuchara
west	el oeste
lam	huida
laborist	el laborista
mademoiselle	señorita
tomorrows	mañanas
tower	torre
traffic	tránsito
law	la suegra
less	menos
laborite	laborista
traitoress	traidora
thirsty	sediento
chatted	charló
catalogs	catálogos
translates	traduce
abdicate	renunciar a; abdicar
seaports	puerto de mar
calcine	calcinar
lavatory	el baño
university	la universidad
technique	técnica
abdominally	abdominalmente
saleswomen	dependientas
intimidate	intimidar
teaches	enseña
wound	la herida
teacher	maestro
lamas	lamas 
spuriously	espuriamente
generous	generoso
floor	el suelo
exhibition	exhibición; exposición
wounded	herida
accessibleness	accesibilidad
necklace	el collar
cancelling	cancelando
doctor	doctor
saliva	saliva
calibrations	calibraciones
enzymatic	enzimático
pacificist	pacifista
pillow	la almohada
spoken	hablado
accessorial	accesorio
traveled	viajó
sport	deporte
janitor	el conserje
attire	atraer
rabbits	conejos
radiology	radiología
symphysis	sinfisís
maceration	maceración
absorb	absorber
lee	sotavento
circulate	circular
leg	la pierna
liable	responsable
quagmire	pantano
cargo	carga
dock	reducir
macerating	macerando
motivating	motivante
neighborhoods	vecindades
night	la noche
pace	paso
fiftieth	cincuentavo (part)
ballet	ballet
callosity	callosidad
pack	paquete
each	cada
lucubration	lucubración
labels	etiquetas
theorem	teorema
abhors	odia
jewels	las joyas
thirty	trenta
iconographer	iconógrafo
workman	trabajador
document	document
saleswoman	dependienta
backbiter	el difamador
mallet	mazo
hackney	trillar
karma	carma
thirst	sed
cadenza	cadencia
chalky	yesoso
attired	atraido
packagers	empaquetadores
chalks	tizas
heliogram	heliograma
caballero	knight
prayer	ruego
laboring	laborando
clam	la almeja
circulates	circula
darkroom	cuarto oscuro
lid	la tapa
megabyte	mega-byte
lie	yacer
calcite	calcita
exhuming	exhumado; exhumar
smell	oler
acquires	vt   adquirir
circulated	circulado (a)
abscissas	abcisas
cacophonously	cacofónicamente
lip	el labio
dogs	los perros
acquired	adquirido
radiometers	radiometros
radiate	radiar
chest	pecho
maidenhood	soltería
tension	tensión
chess	el ajedrez
ballad	balada
abscissae	abcisa
labeled	etiquetado
doubt	dudar
verbal	verbal
abstractedness	abstrasencia
tamed	domado
aching	que duele
page	página
full	lleno
pepper	la pimienta
destiny	destino
motivation	motivacion
steels	aceros
tablespoons	cucharas
millennium	3012
stubbornness	obstinación
accompanyists	acompañantes
nanoseconds	nanosegundos
painful	doloroso
witchcraft	brujeria
pain	el dolor
calcium	calcio
haberdasheries	mercerías
center	el centro
purchase	la compra
accidently	accidentalmente
titles	títulos
supper	la cena
pair	par
toothbrushes	cepillos de diente
tobacconist	tabaconero
paid	pagado
plugs	clavijas
thereabout	alrededor
cabbage	la col
absurdism	absurdismo
celebrities	célebres
contemplating	meditando
readjusts	reajusta
three	tres
eagles	aguilas
eaglet	aguiluchó l'aiglon (el aguilucho)
toasts	brindís(wine) or tostadas(bread)
plumb	plomo
season	estaci\'on del añno (noun); condimentar (verb)
lonely	solitario
bien	good
pale	pálido
tenant	inquilino
hardware	circuitos
plutocratic	plutocrático
chicle	chicle ( gum)
cowboy	el vaquero
threw	tiró
abasements	humillaciones
tarantulas	tarantulas
symptomatic	sintomático
meals	las comidas
abjure	renunciar
log	el leño
madder	m/as enfadado
translator	traductor
abating	deprimente
teaching	enseñando
accidental	accidental
anthropophagy	antropofagia
computer	computadora
tacking	clavar tachuelas
planets	planetas
low	bajo
anthrop	antrop
doll	muñeca
baggy	holgado
biff	biffar
baboon	babuíno
contemplation	meditación
chimpanzees	chimpancés
absurdity	absurdo
babyhood	niñez
habituate	habituar
abandoning	abandonando
fellow	socio (fellow of a society)
macerations	maceraciones
tackily	abandonado
macropathology	macropatología
door	la puerta
quick	pronto
narcolepsy	narcolepsia
husband	el esposo
zone	zona
affair	asunto
cabbala	cábala
absolutistic	absolutista
tetanize	tetanizár
banana	platano
obtain	obtener
absences	ausencias
adept	adepto
curiosity	curiosidad
amiable	amistable
sacrifice	sacrificio
teller	cajero ( cashier)
tactical	táctico
harlequin	arlequín
pause	pausar
August	agosto
fumble	manosear
rainbow	el arcoiris
accumulable	acumulable
comets	cometas
ease	facilidad
fulcrum	fulcro
part	parta
radians	radianes
radiant	brillante
principal	spainsh
east	el este
accountings	contabilidades
temperaments	genios
radios	radios
caiman	caimán
arthropod	artropodo
technocrat	tecnócrata
boycott	boicoteo; boicotear(verb)
park	el parque
statues	estatuas
washed	lavo
zoom	pasar zumbando
absentee	ausente
absented	ausentado
tides	mareas ( as in weather)
dope	la mota
capitol	capitolio
ears	orejas
economics	economica
tacitly	tácitamente
someone	alguien
gratitude	gratitud
earn	ganar
iconographic	rhtrhyhgf
terrors	terrores
antenatal	prenatal; antenatal
earl	conde
lightbulb	la bombilla
apartment	apartamento
ladybugs	mariquitas
gallantry	galantería
machinate	maquinar
fiery	ardiente
path	la senda
acoustics	acústica
accepting	aceptando
chromosomal	cromosomál
pass	pasar
mile	la mila
past	pasado
milk	la leche
dorm	la residencia universitaria
tributary	tributo
easy	fácil
bucket	el cubo
graveyards	camposantos
abbots	abates. no abades.
census	apadronamiento
oceans	oceanos
pluvial	pluvial
adult	adj & n  - adulto -ta (mf)
pluralistic	pluralístico
stepwise	progresivo
radish	rabano
oatmeal	avena
octagons	octagonos
accelerating	acelerando
clockwork	mecanico
adaptive	adaptativo
academician	académico
October	octubre
adoption	adopción
harmonize	armonizar
dove	la palomita
chaotic	caótico
chimpanzee	chimpanc/e
thankfulness	agradecimiento
calibrators	calibradores
medieval	medieval
cancelations	cancelaciones
therapists	terapeutas
acuteness	agudeza
lockers	los casilleros
testimonials	testimonios
tablecloths	manteles
afterbirth	(fam) placenta; secundinas (fam)
jackknife	navaja
inch	pulgada
branchial	branquial
stocking	la media
down	abajo
acceleration	aceleración
bracken	helecho
habit	hábito
kingdoms	reinos
bird	pájaro
bracket	abrazadera; soporte
legal	legal
radius	radio
seated	sentado
inching	despacio
torsos	torsos
chromosomes	cromosómas
flagellar	flagelar
caftan	caftán
month	el mes
tackle	equipo
cahier	cuaderno
brainwashing	lavado de cerebro
macrofossil	macrofosil
locust	la langosta
rather	mejor que
machinates	maquina
machinated	maquinado
gallantly	galantemente
title	título
whore	puta
lackeys	lacayos (sirvientes)
miss	extrañar
undershirt	la camiseta
incentives	incentivos
plantation	plantación
bite	morder
backstairs	escalera de atras
brainteaser	rompecabezas
locusts	las langostas
abode	sin domicilio fijo
permission	el permiso
travels	viajes
beach	la playa
faction	faccion
tenths	decimos
blanket	la manta
harmonium	armonio (inst.musical)
abberations	desvío
exhausted	agotado
charisma	carisma
cigar	el puro (mex)
testified	testífico
calamities	calamidades
karat	kilate
acidimeters	medidores de acidez
fear	temer
incessant	incesante
adoptive	adj  - adoptivo
cookie	la galleta
garlics	ajos
aberrate	desviar
aerosolized	adj  - en aerosol
bits	los bits (computadora)
chalet	chalét
torrent	torrente
field	el campo
accelerative	acelerativo
amalgamate	amalgamar
server	server
magistrature	magistratura
oceanographers	oceanografos
terrorizes	aterrar
goodbye	adios
terrorizer	terrorista
skin	la piel
seashores	costas del mar
tailor	sastre ( noun)
mad	enojado
terrorized	aterrado
laundry	(laundromat) la lavandería
thunderbolts	relámpagos
mal	bad
quadratically	cuadráticamente
man	verón
leisure	el ocio
map	el mapa
twenty	veinte
caliphal	califal
addict	adicto
traditionalism	tradicionalismo
toothpaste	pasta de dientes
backless	sin espalda
halyard	driza
spectacled	que lleva gafas
oceanography	oceanografia
hairdressers	peluqueros
spectacles	gafas
tasters	gustadores
contemplates	proyecta
feet	los pies
carnivals	carnavales
tacked	sujeto con tachuelas
quadrants	cuadrantes
casino	casino
feel	palpar
terribly	terriblemente
technologically	tecnológicamente
lubricants	lubricantes
readout	indicación
terrible	terrible
tabularization	tabularización
textbook	libro de texto
ideal	ideal
vagina	vagina
abduction	secuestro
comedy	la comedia
getup	levantarse
ideas	ideas
chlorate	cloráto
acclimatize	climatizar
adhesions	n - adherencias
background	de fondo
radioscopic	radioscópico
linoleum	linóleo
handsome	guapo(a)
bacchanalian	bacanálico (a)
men	los hombres
repeat	repetir
anisotropic	anisotropous
poetic	poético
absorbs	absorbe
octagonal	octagonal
exactly	en punto
orange	la naranja
occiput	nuca
backpack	mochila
circulation	la circulacion
abjectness	abyección
lodge	la casa del guarda
pluton	plutón
rayon	rayón
abducting	separando
magniloquent	magnilocuente
about	de
weekday	día de la semana
danger	el peligro
machinator	maquinador
pluralized	pluralizado
temperamentally	temperamentalmente
character	carácter
abashment	vergüenza
above	encima
addendum	adenda
tales	cuentos  ( stories)
height	la altura
linoleic	linoleico
certificated	certificado
tactlessness	torpeza
gyms	gimnasios; gimnasias
hairbrush	cepillo de pelo
frozen	congelado
centerpieces	centros de mesa
chaotically	caóticamente
jackboot	bota de montar
laboriously	laboriosamente
quality	la calidad
certificates	certificados
databanks	banco de datos
animal	el animal
pluralizer	pluralizador
sincere	sincero
lefties	surdos
abruptness	precipitación
backwardly	retrospectivamente
March	marzo
believe	creer
fell	tralar
boots	botas
charlatans	charlatanes
grandsons	nietos
attentively	atentamente
destruction	ruina
occipital	occipital
dirty	verde
though	aunque
blizzard	la ventisca
polis	polis
swamp	el pantano
tolerantly	con tolerancia
abscond	escaparse
mammary	mamaria
badgers	tejones
open	open
obliqueness	oblicuidad
salvation	salvación
chronology	cronología
aberrant	anómalo
incapacitated	incapacitado
greedy	goloso
tobacco	tabaco
incapacitates	incapacíta
sidewalk	la acera
abound	abundar
studying	estudiando
suitcase	la maleta
achromatism	acromatismo
beard	la barba
lobster	la langosta
gardener	el jardinero
daemon	espiritu
abort	aborto
flying	volando
charmed	encantado
tachygraphy	tquigrafia
allow	permitir
alloy	aleación
talkers	habladores
castigate	castigar
poisonous	venenoso
vegetable	la legumbre
bitter	amargo
abstractors	abstractores
d'art	de arte
tightwad	tacaño
backstage	bastidores
activists	activistas
lakes	lagos
daddies	padres
aculeate	aculeado
waistband	cinturón 
placentations	placentaciones
bedroom	el dormitorio
seagull	gaviota
cells	cédulas
money	el dinero
healthy	sano
teleconference	telecomferencia
transcending	trascendiente
forever	para siempre
oblique	oblicuo
oceanology	oceanologia
heiress	heredera
madcap	calavera; botarate; temerario
achievement	logro
mafioso	niembre de la mafia
adaxial	adaxial
fingers	los dedos
mop	gerga
movies	el cine
elevator	el ascensor
transvestite	transvesti 
fickle	inconstante
hazelnut	avellano
animalcule	animálculo
sprinter	velocista
anthology	antologia
chronometer	cronómetro
benchmark	evaluación comparativa
talon	talón
toward	hacia
books	los libros
mammals	mamíferos
haggled	pretéritóparticipio pasado de haggle
chromosomic	cromosómico (a)
fertilize	fertilizar
beamy	radiante
acclimating	aclimatando
internal	interno(a)
tongue	lengua
churn	revolver(se)
tithe	diezmar
enjoy	gozar
caress	acariciar
abduce	abducir
choline	colína
accosted	acosó
beans	frijoles
writing	escritura
academy	academia
acclimation	aclimatación
academe	academia
medley	mezcolanza
tremendously	tremendamente
destructive	destructivo
adsorbent	adj  - adsorbente
lefty	surdo
thirdhand	terceramano
sleeve	la manga
censor	censurador
abduct	secuestrar
voice	la voz
adaption	n - adaptacion (accent over  o)
understandability	comprensibilidad
barbarians	b/arbaros
float	flotar
mediums	medios
aboil	abolir
transsexual	transexual
olive	la aceituna
exiguous	exiguo
caliginous	caliginoso
cascade	cascada
coward	el cobarde
exigencies	exigencias
calmative	calmante 
stereochemical	estereoquimico
accommodatingly	acomodadamente
acrophobic	acrofobia
diehard	duro de matar
acephalous	acefalo
mud	el barro
thingamajigs	cachivaches
abolition	supresión
tabulated	tabulado
chunk	el trózo
jade	jade
castanets	castañuelas
counterproposal	contrapropuesta
captivate	cautivar
transcendentalizes	trasciende
talks	charlas ( speeches)
destinies	destinos
abbreviations	abreviaturas
foggy	nublado
obliquely	oblicuamente
notified	notificó
daintier	delicado
toad	batracio ( animal)
greens	verdes
inclinable	inclinable
ultimately	ultimadamente
command	mando
jack	[off] masturbarse
dessert	el postre
temple	el templo
abodes	domicilios
transcended	trascendió
thimble	dedal ( sewing)
annotate	notar
theorems	teoremas
deactivated	desactivado
legalist	el legalista
magnanimously	magnanimosamente
music	la música
torrid	tórrido
tennist	tenista
because	porque
July	julio
transcendental	trascendental
educate	educár
anthropoid	antropoide
aerobics	n pl - aerobicos (accent over 1st  o)
agreement	el acuerdo
upgrade	 mejoramiento
charismatic	carismático
overload	sobrecargar
earliness	precocidad
science	la ciencia
aboard	a bordo de
June	junio
forest	el bosque
icebergs	témpano
certifies	acredita
occupations	ocupaciones
backwater	remanso
sleep	dormir
crumb	la miga
refuse	rehusar
calcic	cálcico
certified	acreditado
oeuvre	obra
threateningly	amenazadamente
aborts	abortos
absolved	absuelto
objectors	objetores
absolutization	absolutización
poisonously	envenenadamente
chewed	masticó
weird	raro
absolves	absuelve
absolver	absolutor
sweet	dulce
anniversary	aniversario
thirtieth	trigésimo
thorns	espinas
trapezoid	trapezoide
eager	ansioso
gratuitous	gratuito
stereophotographic	estereofotografico
palaeontology	paleontología
sled	el trineo
boyhood	muchachez
acclamation	aclamación
napkins	servilletas
narrate	narrar
addenda	adendas
female	hembra (animal
polarity	polaridad
obligatory	obligatorio
cruel	cruel
falsified	falsificado
calligraphers	calígrafos
abaft	a popa
jail	jaula
touchable	tocable
bored	aburrido
thorny	espinoso
chimney	la chimenea
baggage	el equipaje
technical	técnico
ytterbium	iterbio 
backside	espalda
ride	montar
occident	occidente
chapels	iglesias
pointillistic	puntillistico
medal	la medalla
capitalism	capitalismo
legalize	legalizar
photographer	photographer
platina	platina
capitalist	capitalista 
mistake	la falta
abridging	abreviando
capabilities	capacidades
abnegator	abnegador
cockroach	la cucaracha
achingly	dolorosamente
toil	laborar ( as in to work)
rich	rico
agencies	agencias
chiefly	principalmente
objectively	objetivamente
toyed	jugueteó
rice	el arroz
accuracies	precisiónes
salesperson	dependiente
acacia	acacia
acetify	acetificar
family	la familia
abscissa	abscisa
gift	el regalo
career	profesión
abiding	permanente
dockage	muellaje (docking fee)
zenithal	cenital
chromate	crom/ado (a)
pagan	pagano
rancor	el rancor
catechism	catecismo
zealot	fanático
wait for	esperar
judge	el juez
darkness	la oscuridad
nap	la siesta
reabsorb	reabsorber
abominate	abominar
similar	semejante
yuppie	yuppie
tackled	equipado
thousands	miles
abnegates	abniega
malnutrition	desnutrición
pajamas	piyamas
temperamental	temperamental
plutonian	plutoniano
carved	tallado
roller	rodillo
tone	tono
aback	hacia atrás
crude	basto
acrylic	acrílico.
potato	la patata
accreditation	acreditacion
thereabouts	en los alrededores
sabbatical	sabático
abrasiveness	abrasividad
abstrict	cercenar
liberator	el libertador
tome	libro ( book)
grandmother	la abuela
tomb	tumba
backstitch	pespunte
thyroids	tiroides
polarize	polarizar
logic	la lógica
tiredly	cansadamente
forgetful	olvidadizo
artichoke	la alcachofa
pointillist	puntillista
acceptedly	aceptadamente
whiter	más blanco
pager	mensáfono
toot	pitar
pointillism	puntillismo
laggard	rezagado
net	la red
cable	cable
nasty	desagradable
academicism	academicismo
new	nuevo
took	tomó
acanthuses	acantos
bandoleer	bandolero
didn't	pasado negativo de "do"
abducing	separación
tool	herramienta
timpani	tímpano
Sunday	el domingo
tons	toneladas
kangaroos	canguros
backups	backups
magenta	rojo purpureo; solferino
torn	roto
lesbians	las lesbianas
abrasives	abrasivos; bruscos (manner)
around	alrededor
accidence	accidente
soulful	conmovedor
talented	talentoso
dictate	dictar
badgered	molestado
abatises	barricadas
accelerations	aceleraciones
cacophony	cacofonía
workable	trabajable
adaptivity	adaptabilidad
teaspoonful	cucharadita
territory	territorio
spurious	espurio
terrains	terruños
ring	el anillo
echo	el eco
cheese	queso
singsong	monótono
inclemency	inclemencia
toreador	torero
acropetally	acropetálicamente
tote	portar 
shoulder	el hombro
dance	el baile
cheers	chín
pearl	perla
underutilization	infrautilización
lipidic	lipídico
nanosecond	nanosegundo
forgiveness	perdón
radiochemist	radioquímico
amaze	pasmar
cherubs	querubines
dictionary	el diccionario
mystery	el misterio
slow	lento
tangos	tangos ( the dance )
rime	rima
iconoclastically	iconoclásticamente
rotten	podrido
abstinently	abstinentamente
ballista	ballesta
students	estudiates
recommend	recomendar
helicopter	helicóptero
advertisement	el anuncio
obeyed	obedecio
aspirin	la aspirina
ripe	maduro
affliction	mal. achaque
poison	veneno
silly	tonto
abstractions	abstracciones
plantations	plantaciones
adoptions	n  - adopciones -f (accent over second  o)
boring	aborrido
absolute	absoluto
abridges	compendia
gossip	los chismes
abridger	compendiador
abovementioned	arriba citado
antecedent	antecedente
chargeable	cargable
abnormally	anormalmente
centimo	centimo
calabash	calabaza
backhouse	letrina
abridged	abreviado
objections	objeciones
zoologist	el zoólogo
landlady	la dueña
houses	casas
branchiate	branquiado
acetylene	acetileno
aerosol	aerosol  -m
chameleon	camaleón
town	pueblo
absorbtions	absorciones
unmarried	soltero
abscised	cortado por abscisión
girl	la muchacha
whatever	lo que; qué
abdominal	abdominal
hackneyed	trillado
earrings	los aros
centime	centimo
gymnast	gimnasta
blind	ciego
color	el color
September	septiembre
perfume	el perfume
cancelation	cancelación
now	ahora
tempered	templado
Tuesday	el martes
lived	vivido
headaches	dolores de cabeza
thoughts	pensamientos
mischievous	travieso
toys	juguetes
backstitches	pespuntes
tastier	gustoso
magnific	magnífico
tablespoonsful	cucharada
what	que
tenaciousness	tenacidad
risk	riesgo
flame	la flama
rise	subir
occupant	ocupante
counterattack	contraataque
eagre	creciente de la marea; ola que forma la subida de la marea
innocence	la inocencia
tastily	gustosamente
nearby	cerca
when	cuando
babysit	hacer de canguro
cacao	cacao
temblor	temblor ( as in earthquake)
grandma	abuela
backstitched	pespunteado
abruptly	repentinamente (leave); bruscamente (speak)
abreaction	abreacción
catch	coger
ideates	idea
nourishing	nutrivito
treason	traición
give	dar
idealism	idealismo
liver	hígados
contention	disputa
lofty	alto
tribunals	tribunales
veal	la ternera
chickens	pollos
abash	avergonzar 
abase	humillar
idealist	idealista
ladies	damas
flake	copo
choicest	mas escogído (a)
occipitally	occipitalmente
backrest	respaldo
plumose	plumoso
flags	banderas
acumen	acumen
stubby	lleno de tocones
modern	moderno
abate	terminar
acknowledging	reconociendo
pines	los pinos
amass	amontonar
earner	ganador
comical	cómico
barbarities	barbaridades
acronym	acrónimo
theologian	teólogo
strawberry	la fresa
dishes	los platos
shirt	la camisa
stockings	las medias
chronologic	cronológico (a)
certain	cierto
incisions	incisiones
levels	los niveles
chorizo	chorizo ( spanish sausage )
macadamize	macadamizar
widow	viuda
applicants	applicante
notification	notificación
earned	ganado
heiresses	herederas
mustard	la mostaza
threaten	amenazar
radiometeorograph	radiometeografo
televisor	televisor
cellar	bodega
market	el mercado
stereophonic	estereofonico
keel	quilla
keep	manutención
eagle	aguila
dictatorial	dictatorial
skate	patinar
weigh	ponderar
acute	aguda
telephoned	telefoneó
launder	lavar (ropa)
telephones	teléfonos
testings	pruébas
caducity	caducidad
chronologer	cronólogo
enzyme	enzima
desperado	desesperado
cauliflowers	coliflores
hackles	happy birthday
hackler	happy birthday
ballast	lastre
shine	brillar
aboral	aboral
idealize	idealizar
tasting	gustando
hackled	happy birthday
multitudes	las multitudes
counteroffensive	contraofensiva
tournaments	campeonatos
translucent	reluciente
camels	camellos
thankless	malagradecido
bring	traer
magma	lava volcanica
sauce	la salsa
hamburger	hamburgesa
morphologic	morfológico
carve	tallar
peach	durazno
heliograms	heliogramas
plasmolytic	plasmolítico
incautiousness	descuidado(a)
thirds	tercios
machismo	machismo
broadband	ancho de banda
peace	paz
brother	el hermano
branchia	branquia
traditionalistic	tradicionalista
laicism	laicismo
tomato	tomate
tenaciously	tenazmente
anterior	anterior a
backers	respaldadores
search	busqueda (noun); buscar (verb)
cadaver	cadáver
attainable	conseguilbe
exhorting	exhortando; exhortar
humanity	humanidad
onions	cebollas
trapeze	trapecio
terrarium	terrario
obligated	obligado
actor	un actor
ceramist	cerámico
bafflers	deflectores
lakeshore	la orilla del lago
Thursday	el jueves
backache	dolor de espalda
maestro	arista eminent en cualquiere de las bellas artes
tigers	tigres
plumbaginous	plumbagíneo
ladylove	amada
teardrop	lágrima
girls	las muchachas
thunder	trueno
acclimate	aclimar
youthfulness	juventud
accounted	contabilizó
chairs	las sillas
seahorse	hipocampo
tachygraphic	taquigráfico
eardrums	tímpano
cancerous	canceroso
cureless	incurable
fourteen	catorce
acolyte	acólito
celebration	festividad
knife	la navaja
abstruseness	oscuridad
temptation	tentación
antennae	antena
Italy	italia
oceanological	oceanologico
carry	llevar
refrigerator	la nevera
lachrymose	lloroso
terrazzo	terraza (terrazzo
zucchini	el calabacín
incarcerate	encarcelar
personality	personalidad
oaf	palurdo
teachers	maestros
oak	roble
class	la clase
oar	remo
oat	avena
carte	carta ( as in a la carte )
chlorophyll	clorófilo
counter	contador (de tiempo)
camelia	camelia
polarimeters	polarímetros
dally	tardar
carts	carretillas
management	gerencia
counted	contado
macromolecules	macromoleculas
very	muy
nakedly	desnudamente
practice	practicar
backdrops	telones
transcribe	transcribir
carol	cantata
bitterness	amargura
abidance	tolerancia
accouterment	equipo
telecourse	telecurso
clamp	apretar
alloys	aleaciónes
abjection	abyección
bakery	panaderia
machineable	maquinable
literally	woertlich
verb	verbo
dictated	dictado
attainableness	asequibilidad
macropathological	macropatológico
traumatized	traumado
chalice	cáliz
traditional	tradicional
cheeks	mejillas
absinth	ajenjo
laicize	dar caracter laico
gypsy	gitanóa
May	mayo
lacuna	laguna
calumniation	calumnia
galloping	galopando
library	la biblioteca
sphere	esfero
camera	camara
sadly	tristemente
bladders	las vejigas
vest	el chaleco
radioautographic	radioautográfico
caliphate	califato
off	apagado
disabilities	incapacidades
transaction	transacción
planimeters	planímetros
pools	las piscinas
edge	orilla
ruling	reglando
orchestra	la orquesta
calming	calmante
torches	antorchas
chronic	crónico (a)
toxic	tóxico
months	los meses
lance	lanzar
doctrinaire	doctrinario
ohm	ohm
squander	malgastar
magistrate	magistrado
cantata	cantata
tetracycline	tetracíclina
tablets	tabletillas
hammer	el martillo
abundantly	abundantemente
keys	llaves
daff	bromear
dales	valles
oil	el aceite
toxin	toxina
technocracy	tecnocracia
brick	el ladrillo
fight	pelear
keyboard	tecla
dads	papas
pretty	lindo
homeless	desposeido
aerobic	adj  - aerobico (accent over 1st  o)
teaspoon	la cucharita
madams	damas
absorbent	absorbente[]
painting	la pintura
radiation	radiación (f)
harangued	arengado
cock	pija
taxidermy	taquídermia
strategic	estratégico
calculus	cálculo
haven't	no tener
pacifications	pacificaciones
estimate	estimar
bookcase	el estante de libros
drip	gotear
tyrannize	tiranizar
toilsomely	laboriosamente
gangsters	pandilleros
daft	zonzo
old	viejo
incinerators	incineradores
ancient	antiguo
abhorring	aborreciente
twelve	doce
daguerreotypic	daguerrotípico
activity	actividad
cabaret	cabaret
travelings	viajes
accordions	acordeones
cabin	litera
enzymes	enzimas
activators	activadores
abolitionists	abolicionistas
liar	el mentiroso
caution	cautela
unemployed	desempleo
freshen	va. refrescarse
incarcerated	encarcelado
ceramics	cerámicas
zodiac	zodiaco
one	uno
garage	el garaje
cents	centavos
abnegation	abnegación (autosacrificio)
calibrate	calibrar
acquaint	conocido
threatens	amenaza
aide	asistente -mf; ayudante -mf; auxiliar -mf
accentuation	acentuación
oaks	robles
technicalities	tecnicalidades
rulings	fallos; decisiones de...
doves	las palomitas
abetment	instigación
sincerity	sinceridad
dandelions	dientes de león
abolisher	abolicionista
amazing	pasmoso
abolishes	abole
lick	lamer
dale	valle
aids	la sida
abiogenetical	abiogenético
tactful	con diplomacia
abolished	abolido
accentuating	acentuando
lice	los piojos
daguerreotypes	daguerrotipos
haggish	embutido escocés
flavor	el sabor
multiplying	multiplicando
towns	pueblos
mustaches	los bigotes
cabby	el taxista
omnipresent	omnipresente
yearly	anualmente
yells	grita
saucer	el platillo
destination	destinación
yoke	sojuzgar
pure	puro
damp	humedo
life	la vida
chloral	clorál
alcoholism	alcoholismo
honey	la miel
idealizations	idealizaciones
tango	tango ( the dance)
spells	los hechizos
wide	ancho
enzymic	enzimático
toothsome	dentudo
aborally	de manera aboral
anthropologist	antropologo
location	la situación
dame	mujer
torment	tormento
software	programa
chains	cadenas
tempestuous	tempestuosidad
zany	bufón
none	ninguno
pupil	a alumno
therapeutic	terapeútico
puss	cara
problem	el problema
asleep	dormido
radioactively	radioactivamente
abandoned	abandonado
combustibles	combustibles
lobsters	las langostas
teaspoons	cucharillas
wife	marida
backspaced	retrocedido
come	venir
yolk	yema de huevo
leather	el cuero
comb	el peine
lift	alzar
backspaces	retrocesos
sexual	sexual
vainglory	vanagloria
sensibly	razonablemente
cabal	conciliábulo
capacity	capacidad
contentedness	contento
ghost	el fantasma
tinware	latería
daemons	demonios
dark	oscuro
copy	la copia
precise	preciso
dare	cariño
sensible	razonable
seasick	mareado
can opener	el abrelatas
cook	el cocinero
cool	chevere
cashiers	cajeros
apologize	disculparse
abstractedly	abstraídamente
amazed	asombrado
kaleidoscope	caleidoscopio
seaside	playa
prearranged	arreglado de antemano
quadrangles	cuadrángulos
thespian	artista 
tomboy	marimacha
owe	deber
antediluvian	antediluviano
date	la fecha
magic	mágico
kilobit	kilobit
academically	academicamente
data	datos
theoretical	teórico
corn	maíz
gynecologicals	ginecológicos/as
chapeau	cabeza ( head )
drum	el tambor
cork	el corcho
stucco	estuco
drug	la droga
comedians	cómicos
incarcerates	encarcéla
rabbet	barbilla
realistic	vivo
macroaggregate	macroagregar
successes	exitos
tactilely	tactilmente
activist	activista
oars	remos
like	como
pamper	chinear
branches	ramas
plutonium	plutonio
activism	activismo
icebox	la refrigeradora
magistracy	jurisdiccion de magistrado
quadrillion	cuatrillón
accumulator	acumulador/ra
ground	el suelo
dash	corre
activeness	cualidad de ser activo.
radioscopy	radioscopía
sagacity	sagacidad
abridge	abreviar
exile	exilio
plexus	plexo
tempest	tempestad
dicks	pollas (vulg)
affairs	asuntos
felon	delincuente
nose	la nariz
oats	avena
cost	costar
fishing	pesquero(a)
lime	uni
dictator	dictador
crankshaft	ciguenal
yore	antaño
snag	un problema
oath	juramento
chuckhole	báche (mex.)
narration	narración
challenge	desafío
certifiable	certificable
babying	ninando
machined	maquinado
your	tus
cafeteria	cafetería
slower	mas despacio
teleconferenced	teleconferenció
acceptability	aceptación
lacquer	pintar con laca
these	éstos
gratuities	propinas
kidnap	seguestar
calculate	calcular
felicitate	felicitar
sister	cuñada
trauma	trauma
kooks	üppou
chimneys	chimeneas
acknowledgements	reconocimientos
noun	substantivo
tonality	tonalidad
baker	el panadero
lion	león
backslider	reincidente
thoughtfully	atentamente
wing	la ala
teleconferences	teleconferencias
wine	el vino
wind	el viento
humble	humillar
eraser	el borrador
flight	vuelo
symphonies	sinfonías
tirelessness	descansancio
obedient	obediente
achieve	lograr
yellow	amarillo
talking	hablando
tribunal	tribunal
plausible	plausible
deluge	diluvio
abscise	abscisa
covenants	alianzas
parsley	el perejil
yowl	aullar
accordionists	acordeonistas
headline	título
yellowish	amarilloso
faced	enfrentado
macadam	s. piedras trituradas para macadamisar; calzada empedrada con ellas.
lips	los labios
blue	azul
bratwurst	salchicha
pocketbook	libro de bolsillo
days	dias
charcoal	carbón
facet	faceta
acceptable	aceptable
chili	chili
actualizations	actualizaciones
chill	escalofrío (med.)
accommodator	acomodador
obdurate	terco
attiring	atractivo
adios	adiós
chronologists	cronólogos
wise	sabio
acceptably	aceptable
pal	amigo
pan	sartén
chanteuses	cantantes
paw	la garra
pay	pagar
list	la lista
babyish	infantil
strange	raro
vaginal	vaginal
candidates	candidatos
vaginas	vaginas
treasury	tesorería
emerald	la esmeralda
child	niño
medium	medio
remove	remover
pear	la pera
haberdashery	mercería
fanatical	fanatico
treasure	tesoro
gravestone	lapida sepulcral
live	vivir
maneuvers	maniobras
chimp	chimpancé
lucrative	lucrativo
with	con
crutches	muletas
flowerpot	el tiesto
there	allí
translocate	translocar
dimple	el hoyuelo
locals	los vecinos
yellowing	amarillando
internationalizes	internacionaliza
cheerfulness	alegría
throats	gargantas
pea	el guisante
habitually	habitualmente
trattoria	parrilla
railing	barandilla
pen	un boligrafo
d'etre	de ser
pet	el animal doméstico
ceased	cesó
acorns	bellotas
cheapskate	tacaño
birth	el nacimiento
idealization	idealización
slowly	lentamente
enzymology	enzimología
academies	academias
internationalized	internacionalizado(a)
tanned	bronceado ( as in suntanned )
toolbox	caja de herramientas
meetings	reuniones
vacancy	vacante
ceramic	cerámica
bailable	achicable
accolade	espaldarazo
choirs	coros
abloom	en flor
cedarwood	cedro
cabman	taxista
caducous	caduco
ceases	cesa
granddaughter	la nieta
plenipotentiary	plenipotenciario
hacker	pirata informático
policemen	policía
maculated	manchado
hacked	pretéritóparticipio pasado de hack
earphones	audífonos
charade	charada
loiter	vagar
pachyderm	paquidermo
arrow	la flecha
chide	regañar
overloaded	sobrecargado
pie	el pastel
pig	el puerco
lactic	láctico
pin	el alfiler
objectiveness	objetividad
stationery	papel
drinking glass	el vaso
stock	acciones
baldness	calvicie
terror	terror
accumulation	acumulación
everyone	todo el mundo
kings	reyes
loins	los lomos
chick	pollito
girlfriend	novia; amiga
tempt	tentar ( to tempt)
snot	moco
snow	nevar
cadmium	cadmio
absolve	absolver
locate	localizar
fruit	la fruta
accost	abordar
cause	causa
lances	lanzas
agitated	agitado
tingles	erizos
cadre	cuadro
working	trabajando
incantation	encantación
abstinent	abstinente
garlic	el ajo
accord	acuerdo
aircraft	el avión
academics	academicas
fiduciary	fiduciario
obey	obedecer
velvet	el terciopelo
tolerability	tolerancia
look for	buscar
cilia	la cilia
machines	máquinas[]
accumulating	acumulando
policeman	policía
saccharin	sacarina
caresses	caricias
accessibility	acesible
centimeters	centímetros
tigress	tigresa
teenagers	adolescentes
theocracy	teocracia
liberty	la libertad
recycle	reciclar
snug	acogedor
meeting	reunión
anthropology	antropologia
daffodil	narciso
absorption	absorción
machinability	maquinabilidad[]
recognize	recognize
bamboo	bambú
radiometric	radiométrico
iambic	iámbico
abnormal	anormal
groovy	chido
abortiveness	calidad de  abortivo
actions	acciones
realist	vivo
calipers	calibres
objectionable	objetable
realism	realismo
prize	el premio
acanthopterygian	acantopterigio
habilitation	habilitación
torrentially	torrencialmente
routing	enrutamiento
hairdresser	peluquero
fabulousness	fabulosidad
mornings	mañanas
absurdum	absurdo
caleche	calesa
tariff	tarifa
escape	escaparse
funny	chistoso
cartographers	cartógrafos
receive	recibir
abstractionists	abstraccionistas
interning	internando
plenary	plenaria
theft	hurto
abstains	abstiene
incensing	inciensando
chronicity	cronicidád
yacht	yate
habilitating	habilitando
backwash	estela
anthracite	antracita
friendship	amistad
incitation	incitación
absconder	fugitivo
internationality	internacionalidad
adjuvant	adj - adyuvante; coadyuvante
incite	incitar
continue	continuar
abolishing	aboliendo
realize	darse cuenta de
accountable	responsable
technicality	tecnicalidad
totalization	total
grocery store	la bodega
guilty	culpable
incise	inciso
receipt	el recibo
capsule	cápsula
internationalism	internacionalismo
candleholder	candelabro
babble	balbucear
tirelessly	descansadamente
ceremonial	ceremonial
internationalist	internacionalista
calliper	calibre
thinker	pensador
obligately	obligatoriamente
overview	visión general
notwithstanding	sin embargo
forgetfulness	olvido
dashing	hermoso
calluses	callos
counterintelligence	contrainteligencia
countdowns	cuentas regresivas
accumulative	acumulativo
prostate	próstata
absconded	oculto
bravery	el valor
tray	bandeja
technostructure	tecnoéstructura
notorious	notorio
abiotically	abióticamente
program	el programa
put	poner
teargas	gas lacrimógeno
terrifies	terroriza
tram	tram
meets	encontra
caves	cuevas
ambulance	la ambulancia
dandruff	la caspa
earplug	tapon de oído
light	la luz
fabulist	fabulista
valuable	valioso
abolitionize	abolicionar
tabs	orejas
abdicable	abdicable
seesaw	balancín
damped	mojado
daybed	cama dia
zealotry	fanatismo
yachts	yates
accentuates	acentuar
helmet	casco
absurdly	absurdamente
theme	tema
fiasco	fiasco
desire	desear
terrified	terrorizado
murmur	murmurar
rainsquall	chubascos
inchworm	gusano medidor
absorptive	absorbente
backgrounds	antecedentes
choice	escogído (a)
travel	viajar ( to travel )
facility	facilidad
incidence	incidencia
baccarat	bacarr/a
cucumber	el pepino
appointment	la cita
stomach	el estómago
transitions	transiciones
adductor	abductor
listen	escuchar
abbacy	abadía
academism	academismo
pussy	micha
abolitionist	abolicionista
abolitionism	abolicionismo
eighty	ochenta
group	grupo
tack	tachuela
gross	asqueroso
porch	el porche
accentuated	acentuado
acclaimed	aplaudido
tact	tacto
teriyaki	teriyaki
tree	arból
macrobiotic	macrobiotico
tactlessly	torpemente
taco	mexican sandwich
macroeconomics	macroeconomia
absolutely	totalmente (totally); ¡por supuesto (que sí)! (certainly!)
notebooks	cuadernos
beachboy	chico de la playa
chiropractors	médicos quiroprácticos
altitude	la altitud
request	pedir
yeomanry	burguesía
capella	a capella
accelerando	accelerating
accompaniments	acompañamientos
their	su 
thirteen	trece
frighten	espantar
lasses	las muchachas
caliph	califa
of course	claro
teapot	tetera
clean	limpio
weepers	lloronas
bacillary	forma bacilar (de bacilo)
fidgety	inquieto
account	cuenta
televise	televisar
innocent	el inocente
laggardly	rezagadamente
tramp	puta ( whore )
traitor	traidor
absconding	fugándose
trip	el viaje
vaulted	saltado
absorbable	absorbible
fictitious	ficticio
jump	saltar
knowledge	conocimiento
soft	blando
happen	pasar
sofa	el sofá
abnormalities	anormalidades
festival	fiesta
maggoty	caprichoso; quimerico
untrans	y[]
chapel	iglesia 
cancellation	cancelación
appetizer	el aperitivo
negotiated	negociado
comer	t.v.
bottle	la botella
brasserie	panaderia
interweave	entretejer
caliper	calibre
capability	capacidad
laicized	dio caracter laico
spark	chisme
comet	cometa
negotiates	negocia
wedding	la boda
laicizes	da caracter laico
takeoff	despegar ( aviation)
tail	el rabio
pistol	pistola
noticeable	notable
transition	transición
traps	trampas
caravel	caravela
telly	televisión ( tv)
purse	la bolsa
backtrack	retrotraer
accountant	el contador
anthropomorphic	antropomorfico
talc	talco
radishes	rabanos
absurd	absurdo
seals	focas; sellos
rubber	la goma
trait	característica
underwear	la ropa interior
talk	hablar
tall	alto
vault	bóveda
train	tren ( noun) adiestrar ( military)
babysits	cuida a un bebe
rafter	viga
planet	el planeta
take	tomar ( verb)
accompany	acompañar
accompanyist	acompañante
curable	curable
centigram	centígramo
figs	higos
thighs	muslos
cinnamon	la canela
landlord	el dueño
tactile	tactil
factious	faccioso
telecommunications	telécomunicaciones
accretion	aumento
backspace	tecla de retroceso
tank	tanque
pluriaxial	pluriaxial
midnight	la medianoche
idiot	idiota
screwdriver	el destornillador
home	hogar
tame	manso
calligraphically	caligráficamente
comforter	confortador
iron	planchar
terrorize	aterrar
idiom	el idioma
macronutrient	macronutriente
explain	explicar
macronucleus	macronucleo
internalizing	internalizando
soon	pronto
sinew	tendón
tablet	tabletilla
tables	mesas
tape	la cinta
lacerate	lacerar
cartographer	cartógrafo
dowry	dote
cream	la crema
heavy	pesado
singe	chamuscar
toupee	peluca ( wig)
affinities	n pl  - affinidades  -f
exhibitions	exhibiciones; exposiciones
cinders	cenizas
cancelled	canceló
machinery	maquinaria
plumbic	plúmbico
carpenters	carpinteros
painted	pintado
gratuity	propina
summer	el verano
abruption	ruptura
seafloor	fondo del mar
abbey	abadía
file	fichero
chloroplast	cloroplásto
greasy	grasiento
brunette	moreno
incidents	incidentes
cacti	cactus
caravans	caravanas
nourish	nutrir
together	juntos
grease	la grasa
health	salud
amber	ambre
quadraphonic	cuadrafónico
trays	bandejas
o'clock	en punto
machine	máquina[]
taffetized	entafetado
return	volver
hafnium	hafnio
laicizations	laicizaciones
townhouse	townhouse
backlash	contragolpe
tablecloth	mantel
laconic	lacónico
accredited	autorizado
serve	servir
annoys	se burla
pacificators	pacificadores
smile	la sonrisa
confused	confuso
towels	toallas
find	hallar
backward	atrasado
lapel	la solapa
cables	cables
inchworms	gusanos medidores
cablet	estacha
guzzled	tragado; engullido
turtle	tortuga
occur	ocurre
cabriolet	cabriolet
breeze	la brisa
fill	llenar
omniscience	omnisciencia
trash	basura
painter	el pintor
abrade	raer
cabled	cableado
task	quehacer ( chore)
transit	tránsito
adolescent	adj & n  -  adolescente
tactics	tácticas
sore	dolorido
exhume	exhumar
laughter	la risa
since	después de
soup	la sopa
caricaturist	caricurista
soul	alma
abundance	abundancia
certificate	certificado (noun)
dangerous	peligroso
racket	raqueta (for tennis)
sour	agrio
accordant	concordante
cartographic	cartográfico
plumber	el plomero
aboveboard	legítimo
hour	la hora
abbas	aint
magazines	las revistas
agitate	agitar; to become agitated agitarse
acropolis	acrópolis
adipose	adiposo
badger	tejón
badges	condecoraciones
caliphs	califas
narrator	narrador
caravan	caravana
canoes	canoas
curiosities	curiosidades
taut	tenso
writer	el escritor(a)
writes	escribe
fence	la cerca
sabbat	sábado
glue	la cola
scream	chillar
accessing	accediendo
yttrium	itrio
oceanographical	oceanografico
fire	la lumbre 
calcitic	calcítico
obfuscated	ofuscado
transients	transeúntes
chastisement	castigo
taxi	taxi
greedily	vorazmente
haircut	corte de pelo
tiger	tigre
absurdness	absurdo
symptom	síntoma
fireman	el bombero
tardiness	tardía
chastity	castidad
odontologst	odontologo
handbags	las bolsas
jewel	la joya
target_language	spanish[]
bananas	platano
trainers	adiestradores
plants	plantas
gymnasts	gimnastas
accordance	conforme
adhesion	n - adherencia
earmuff	orejera (protección contra el frío)
people	la gente
democracy	la democracia
lagoon	laguna
abandon	abandonar
celebrations	festividades
fish	pescado
sacrilege	sacrilegio
catatonic	catatónico
celebrant	festejante
alarming	alarmante
announcer	el locutor
cadge	sablear
obduracy	terquedad
cannon	cañon
obligations	obligaciones
branchless	sin ramas
tranquilly	tranquilamente
inside	dentro
mainly	principalmente
motorcycle	la motocicleta
graveyard	camposanto
leaves	las hojas
tavern	taberna
adhesive	adj - adhesivo; ______ tape - tela or cinta adhesiva
chestnuts	castañas
five	cinco
abstractable	abstraíble
aniseed	an/is
celebrate	festejar
castigator	castigador
acidness	acidez
coconut	el coco
hunger	la hambre
announced	anunciado
plutonic	plutónico
youthful	juvenil
radiotherapy	radioterapia
campaign	campaña
yawning	bostezando
qua	en funciones de
abdication	renuncia; abdicación (de un monarca)
acrobatically	acrobaticamente
tellers	cajeros (cashiers)
father	el padre
readjustment	reajuste
towers	torres
backpacker	mochilero
tameless	indomable
testudo	testudo(one with a  big head)
abalone	abulón
accustom	acostumbrar
adaptational	adaptacional
antedate	preceder; ser anterior a
accented	acentuado
bandit	bandido
madness	locura
aberrantly	aberrantemente
again	otra vez
artificial	artificial
chastise	castigar
carryall	cargatodo
chronological	cronológico (a)
employ	emplear
mouthwash	el enjuague
fable	fabula
caldron	calderón
during	durante
balcony	balcon
annotated	notado
dances	baila
grammar	gramatica
price	el precio
yelled	gritó
games	juegos
incinerating	incinerando
typhoon	el tifón
acoustically	acústicamente
addressers	remitentes
d'etat	de estado
laconized	laónizados
macroinstruction	macroinstrucción
cabalism	cabalismo
cherish	querer
agree	acordar
cabalist	cabalista
dancer	bailarín
occlude	obstruir
accessions	accesos
balalaika	balalaika
favorite	favorito
danced	bailó
californium	californio
narrated	narrado
testicles	testículos
incautiously	descuidadamente
thumb	el pulgar
damages	daños
magnanimity	magnanimosidad
stereotropism	estereotropismo
cadet	cadete
quadruplet	cuádruplo
incarnations	renacimientos
introductions	introducciones
finger	el dedo
ladybirds	mariquitas
pneumaticity	neumaticidad
agency	agencia
railroad	el ferrocarril
multitude	la multitud
countermeasure	contramedida
accenting	acentuando
comma	la coma
damaged	dañado
caddy	estuche
abbot	abad
lawyers	los abogados
televisions	telévisiones
macaronies	macarrones
prefer	preferir
abridgement	compendio
tight	apretado
riming	rimando
capriciously	caprichosamente
abysmally	malísimamente
arrange	arreglar
bottom	el fondo
passiveness	pasividad
accidents	accidentes
travelers	viajantes
toilets	inodoros
calorie	caloría
mackerels	caballas
oceanologist	oceanografo
squid	calamar
intervention	intervención
rumble	retumbar;hacer estruendo; ruido sordo;asiento trasero de un cupe
caloric	calorífico
thugs	malandros
accorded	acordado
incineration	incineración
arthritic	artrítico
oligarchic	oligarquico
accommodated	alojado
frequent	va. frecuentar
cockatoo	cacatua
terrorist	terrorista
jealous	celoso
petal	el pétalo
pneumonia	neumonía
terrorism	terrorismo
pneumonic	neumónico
chauvinists	machistas
cartomancy	cartómancia
castigates	castiga
bacchanalia	bacanal
municipalities	las municipalidades
expensive	caro
cemented	encementado
heliocentric	heliocéntrico
trade	comercio
trajection	trayectoria
round	redondo
accommodates	hospedar
ambassador	embajador
castigated	castigado
comic	comer
horses	los caballos
polarizing	polarizando
absentminded	distraído
obfuscating	ofuscando
kangaroo	canguro
accuracy	precisión
negotiant	negociante
building	el edificio
locksmith	el cerrajero
triangles	triángulos
ablution	ablución
rag	trapo (piece of cloth)
magnetisms	magnetismo
terrain	terruño
ran	corrió
packaged	empaquetado
rap	tocar
teasingly	burlonmente
internally	internamente
rat	la rata
younger	menor
raw	crudo
adaptability	adaptabilidad
cartography	cartografía
ray	irradiar
packages	empaques
topiary	topiario
packager	empaquetador
snore	roncar
adenosine	adenosina
ibis	ibis
nationality	nacionalidad
artful	diestro; habilidos; astuto; artificioso
absoluteness	absoluto
poster	el cartel
ringing	sonando
throat	la garganta
wintered	pasó el invierno
flagellants	flagelantes
mopping	trapear
omnipotent	omnipotente
telephotography	telefotografía
abducts	secuestra
abc	abecedario
saint	san
caribe	caríbe
abets	encubre
stereoisomer	estereoisomero
reconciliation	reconciliación
calling	llamado ( as in calling in life)
polemically	polémicamente
radiometrically	radimétricamente
tourists	turistas
ace	as
labialization	labializacion
magniloquence	magnilocuencia
saddle	montura
red	rojo
act	n- acto
transmission	transmisión
helper	ayudante
duck	el pato
magnificence	magnificencia
yearbook	anuario
finish	acabar
helped	ayudado
moustache	el bigote
add	agregar; (arith) sumar
commendable	recomendable
girlfriends	amigas
addressees	destinatarios
barbarism	barbarismo
icicles	los carámbanos
stereophotography	estereofotografia
threesome	trío
ruins	ruinas
therefore	por eso
activation	activación
nourishment	sustento
puddle	charco
magically	mágicamente
omelette	la tortilla
incendiary	incendiario(a)
prevent	prevenir
transcends	trasciende
spareribs	costillas
sorry	siento
dodder	temblar
bacillus	bacilo
lacework	encajes
obfuscation	ofuscacion
incapable	incapaz
anthologies	antologias
absentmindedness	olvidadizo
torero	torero
label	etiqueta
message	el mensaje
aquarium	el acuarium
bagpiper	gaitero (a)
bagpipes	gaitas
terreplein	terraplén
truth	la verdad
feminism	feminismo
theorize	teorizar
age	edad -f;   middle age - edad madura or mediana; old age - vejez -f
crab	el cangrejo
cabs	taxis
chewable	masticable
lipids	lípidos
smaller	menor
dining room	el comedor
incantations	encantaciones
movie	la película
popcorn	las palomitas
tendency	tendencia
ago	hace; atrás (2 wks ago) hace dos semanas or dos semanas atrás
yearn	desear
rib	la costilla
accessed	accedido
chronicles	crónicas
incinerations	incineraciones
carbohydrate	carbohídrato
chessboards	tablas de ajedrez
contemplations	meditaciones
macerators	maceradores
muscles	los músculos
tacky	pegajoso
backseat	asiento trasero
rim	llanta
strangely	extrañamente
consumptive	tísico
accesses	accesos
acetamide	acetamida
tornados	tornados
algorithm	algoritmo
telepathy	telepatía
translatable	traducible
whistle	silbar
chamomile	manzanilla
yeast	levadura
economized	economisádo
exit	la salida
octagonally	octagonalmente
mailbox	buzón
system	sistema
dockyard	arsenal
animated	animado
aid	n -ayuda; auxilio; vt ayudar asistir
carefulness	cuidado
other	otro
United States	estados unidos
uncle	tio
haberdasher	camisero
air	el aire
defeat	spanish
pneumatic	neumático
wastebaskets	basureros
accommodate	acomodar
tenacity	tenacidad
naiveness	ingenuidad
speak	hablar
terrace	terraza
ruination	ruinacion
sacred	sagrado
tender	tierno ( as in gentle)
pacificator	pacificador
squandering	despilfarrando
braise	brasear
tacos	mexican sandwiches
dactyl	dáctilo
meditate	meditar
tribulation	tribulación ( woe )
boat	el barco
heirloom	herencia (objeto valioso familiar)
future	el futuro
meditation	meditación
labia	labia
movement	el movimiento
icing	alcorza
plumbago	plbago
pachydermal	paquidérmico
meatball	alb"ó"ndigas
abided	moró
calcified	calcificado
glove	el guante
municipality	la municipalidad
dicotyledon	dicotiledon
tolerable	tolerable
body	el cuerpo
abashing	avergonzando
brains	inteligencia; cabeza
cage	la jaula
acumination	acuminación
insect	el insecto
spud	patata (slang)
ale	cerveza
all	todo
always	siempre
abhorrence	odio
already	ya
applicable	aplicable
icily	iconógrafo
magisterial	authoritario; dominante; pomposo
weevil	gorgojo
tenebrous	tenebroso
cafe	café
contemporary	contemporáneo
sadden	entristecer
abider	morador
abides	mora
ladyship	sñnoria
prayers	ruegos
tolerably	tolerablemente
toiled	laboro
canned	enlatado
accession	acceso
chemise	camisa ( men's shirt)
tacit	tácito
and	y
ration	ración
chaperon	chaperón
chemist	químico
maggot	cresa; gusano; larva
abroad	en el extranjero (to be); al extranjero (to go)
chauvinistic	machista
ant	la hormiga
brainy	muy inteligente; talentudo
tacks	tachuelas
macrocephalic	macroencefalico
acerbity	acerbidad
ladder	escala
untie	desatar
campesinos	country folk
chinaware	vajilla
transcendentally	trascendentalmente
until	hasta
thimbles	dedales (sewing)
machinable	maquinable
educates	educa
accurate	exacto
benchmarking	evaluación comparativa (hacer una)
thought	pensamiento 
quadriplegic	paralítico
dichotomy	dicotomía
legend	la leyenda
taste	gusto
treaties	pacto ( pact )
medleys	mezcolanzas
tapioca	tapioca
acclimatizers	climatizadores
tagged	etiquetado
cake	torta
calligrapher	calígrafo
boil	hervir
lightning	el relámpago
littlest	menor
nail	uña
testament	testamento  ( will
tattletale	chivato ( cuban slang)noun
toilet	retrate
territories	territorios
triangular	triangular
calculations	cálculos
tasty	sabroso
aberrated	desviado
cellars	bodegas
destructible	destructible
algebra	algebra
odor	olor
cookies	las galletas
bacillar	bacilar
came	vino
captive	cautivo
where	donde
arm	el brazo
art	arte
thoughtful	atento
beige	beige
call	llamar
calm	calmar ( verb)
kick	cocear
calf	chivo
ask	preguntar
theories	teorias
counterespionage	contraespionaje
rub	frotar
rug	tapete
zapping	zapeo
run	correr
rum	el ron
takeout	para llevar ( as in take out food )
cans	las latas
acinus	ácino
rut	rut
mother	madre
mouse	ratón
view	la vista
ate	comi
yourself	tú mismo
newest	el mas nuevo
palace	palacio
accomplishing	cumpliendo
taboo	tabú
footage	documental
plumbeous	plúmbeo
camp	campo
tentacle	tentáculo 
oceanologically	oceanologicamente
accosts	abordar
name	el nombre
crow	el cuervo
cane	bastón ( as in walking stick)
neighborhood	el vecindario
abatement	descuento
thematic	temática
Christmas	la navidad
mood	el humor
plurals	plurales
abolish	suprimir
absence	ausencia
telefilm	telefilm
book	el libro
truck	camion
negative	negativo
acids	acidos
gloves	los guantes
crying	llorando
stupidly	estúpidez
abounding	abundando
boot	bota
abbreviate	abreviar
racecourse	pista de carreras
bone	el hueso
bracelet	pulsera
radically	radicalmente
laceration	laceracion
mouth	la boca
thirdly	tercera
acrobatic	acrobático(a)
labyrinth	laberinto
calligraphic	caligráfico
kiosk	kiosko
cape	capa
galaxies	galaxias
leader	el líder
casa	house[conjunction]
yard	yarda
iced	escarchado (cake)
negotiable	negociable
cart	carretilla
axe	la hacha
looser	sueltos
cast	arrojar
greaten	mejorar
piano	el piano
temperatures	temperaturas
slice	rebanar
broad	ancho
cash	efectivo
lacerating	lacerando
humiliate	humillar
abutments	estribos
accidentalism	accidentalismo
cars	los coches
chapelles	sombreros ( hats )
moon	la luna
accidentalist	aacidentalista
jungle	la selva
card	tarjeta
radiochemistry	radioquímica
care	cuidado
damage	daño
boss	el jefe
tolerated	toleró
abridgment	abreviación
feminine	femenino
centesimo	centésimo
fulfilled	cumplió
tolerates	tolera
fireplace	la chiminea
kilo	kilo
transfers	transferencias ( noun)
seldom	raramente
homosexual	homosexual
protect	proteger
kayak	kayak
cockpit	cabina [de un piloto]
abjured	abjurado
more	más
cabotage	cabotaje
kill	matar
tablespoon	la cuchara grande
abjures	abjura
aggravate	agravar
cats	los gatos
tailors	sastres ( noun)
abjurer	abjurar
painters	pintores
fulfiller	cumplidor
accounts	cuentas
yarn	hilo
bitches	putas
habits	hábitos
sealant	sellador
caged	enjaulado
earlobe	lóbulo
arterialization	arterializacion
simple	sencillo
calcific	calcificar
babysitter	niñera
labors	las obras
abhorrently	en forma aborreciente
cages	jaulas
talent	talento
tachometers	tacómetros
balladist	baladista
negotiate	negociar
bedspread	la colcha
cave	la cueva
package	empaquetar
habitualize	acostumbrar
king	el rey
cadastre	catastro
both	ambos/as
brainwash	lavar el cerebro a; 
transfer	transferencia ( noun)
affection	n afecto
forgiving	perdonador
diaper	el panal
centimeter	centímetro
polemic	polémica
alto	long
theorist	teórico
database	base de datos
tortoise	jicotea
patient	paciente
sad	triste
accompanying	acompañando
move	mover(se)
yawl	yola
barbarize	barbarizar
yawn	el bostezo
earnestly	seriamentéintensamentéde veras
also	tambien[conjunction]
nationalize	nacionalizar
sandwich	el bocadillo
say	decir
enough	bastante
increase	aumentar
technologic	tecnológico
educated	educado
favor	el favor
facetious	gracioso
zither	cítara
commandant	comandante
bad	malo
bag	bolso
boys	los muchachos
facile	vivo
acetyl	acetilo
kiss	besar
laconism	laconismo
ban	prohibicion
mackerel	caballa
bar	barra
suffer	sufrir
bat	murci"é"lago
pamphlet	folleto
soaked	empapado
documentation	documentación
hazardous	peligroso
aboveground	sobrenivel
angry	enojado
haggle	regatear
incidentals	a music notacion symbol
street corner	la esquina
canceled	canceló
chemical	químico
applause	el aplauso
greatly	grandemente
dean	decano
sponge	la esponja
bachelors	solteros
deal	trato
strong	fuerte
abuse	abuso
accursed	maldito
affect	n  - (psych) afecto; vt afectar
deaf	sordo
icon	el ícono
facing	paramento
dead	muerto
eyes	los ojos
sea	el mar
amuse	divertir
sabotaged	saboteado
see	ver
tastefulness	gusto
effectual	eficaz
earners	ganadores
dear	querido
seafood	mariscos
categoric	categórico
academical	académico[conjunction]
sew	coser
iconographical	eth
counteroffer	contraoferta
sex	tener sexo
aberrations	desvíos
sample	muestra
abuts	lindar
planetary	planetario
transmissible	transmisible
fighter	luchador
earnest	seriedad
haggis	morcilla
bed	la cama
bee	la abeja
beauty	la belleza
circulatory	circulatorio (med)
stroll	andar
labored	trabajado
pluralistically	pluralísticamente
chipmunk	top/o
laborer	jornalero
absents	ausentes
sabotages	sabotajes
chrome	crómo
brainpower	fuerza intelectual
transcripts	transcripción
complain	quejarse
zeal	celo
enchilada	enchilada
she	ella
debt	deuda
little	poco
abiological	abiológico
killers	asasinos
ballerina	bailarina
checkers	damas ( game)
forgive	perdonar
ladders	escalas
damask	damasco
capable	capaz
lemon	el limón
sit	sentarse
ballot	encuesta
naively	ingenuamente
six	seis
eyebrow	la ceja
oven	orno
tabac	tabaco
pneumatology	neumatología
packaging	empaquetando
football	futbol
identifications	identificaciones
acceptableness	aceptabilidad
absorbant	absorbente
dichromatic	dicromatico
stereophonically	estereofonicamente
avoid	evitar
fresh	adj. fresco
abstentions	abstenciones
humans	los humanos
big	grande
amazement	pasmo
transmits	transmite
polemicist	polemicista
select	escoger
thankful	agradecido
recommendation	recomendado
ladybug	mariquita
chanson	cancíon ( song )
bit	el bit (computadora)
ski	esquiar
thanks	gracias
adenoma	adenoma
plasodesma	plasmodesmo
calumniate	calumniar
tasks	querhaceres (chores)
anthologize	hacer una antologia de
sky	el cielo
tiptoe	de puntillas
acronyms	acrónimos
gymnasium	gimnasio
large	grande
satisfied	satisfecho
tomorrow	mañana
transactions	transacciónes
acceptors	aceptadores 
grandmas	abuelas
plumule	plúmula
cachalot	cachalote
toothless	sin dientes
doctrine	doctrina
begin	empezar
Germany	la alemania
gypsies	gitanos/as
cableway	cablecarril
abandonments	abandonos
thunderbolt	rel/ampago
boyfriend	novio
exhumed	exhumado
weekend	fin de semana
oceangoing	maritimo
acanthocephalan	acantocéfalo
arterioles	las arteriolas; las pequeña arterias
abhorrent	odioso
exhumer	exhumador
legends	las leyendas
octahedra	octaedro
abroach	espitado
tradition	tradición
dictatorially	dictatorialmente
table	mesa
speakeasy	un bar prohibido (se usaba en los eeuu cuando fue prohibido el vender o beber el alcohol)
change	cambio
inclemently	inclementemente
paella	paella
acceptances	aceptaciónes
motions	movimientos
traumatize	traumar
negation	negatión
theirs	sus
toying	jugueteando
abstentious	abstencionista
polarimeter	polarímetro
several	varios
toothbrush	cepillo de dientes
bragging	fanfarronadas
office	la oficina
son	el hijo
adenoid	adenoide
chancy	arriesgado
theist	teísta
theism	teísmo
aardvarks	cerdos hormigueros
synapse	sinapsis
rations	las raciones
in agreement	de acuerdo
announcements	anuncios
spy	espiar
tense	tenso 
polarities	polaridades
tenth	décimo
accreditations	acreditaciones
box	la caja
boy	el muchacho
corduroy	la pana
racial	racial
radiochlorine	radioclorina
chaperone	chaperón
hazelnuts	avellanos
facial	facial
technic	técnico 
chance	oportunidad
tearful	lloroso
brahma	brahaman; bracman
nature	naturaleza
wheel	la rueda
carcinogen	carcinógeno
cacciatore	hunter
c'mon	vamos
apricot	el chabacano
clerk	el dependiente
oatcake	pastel de avena
internationalize	internacionalizar
amen	amén
calculators	calculadoras
planimetric	planimétrico
occurrences	ocurrencias
dancing	bailando
acetic	acético
paint	pintar
animate	animar
bra	sujetador
eastward	al este
abeam	de través
friend	el amigo
mushroom	el hongo
ached	dolió
alcohol	alcohol
deny	negar
pleasure	el gusto
acronymically	acronímicamente
morning	mañana
horse	el caballo
aches	duele
actors	los actores
detour	el rodeo
radiobiologically	radiobiologicamente
autumn	otoño
motor	motor
dormitory	la residencia universitaria
cargos	cargas
comedienne	cómica
sun	el sol
cabriole	cabriola
ma'am	señora
obligate	obligar
secretary	la secretaria
actively	activamente
copper	el cobre
incense	incienso
obdurately	tercamente
knights	caballeros
storm	la tormenta
manager	el gerente
bacchanal	jodienda
cartoon	muñequitos
amid	entre
anthologist	antologista
threatened	amenazó
tranquilizers	tranquilizantes
store	la tienda
abusiveness	abusividad
backwood	bosque
centurion	centurión
tarts	tartas ( as in little cakes)
bug	error
gallop	galope
threatener	amenazador
tergiversate	tergiversar
toolboxes	cajas de herramientas
story	el cuento
but	pero
bus	autobus
sincerely	sinceramente
torpedos	torpedos
calamitous	calamitoso
buy	comprar
incitant	incitante
express	expresar
icier	más helado
tactfulness	consideraci'on
testis	testículo
racists	racista
internalize	internalizar
zero	cero
abdicated	abdicado (participio de abdicar)
written	escrito
polemics	polémicas
taciturn	taciturno
exhortation	exhortación
hackle	pelo erizado
chairmanship	presidencia
ranch	la finca
ocean	oceano
desk	el escritorio
windscreen	el parabrisa (se usa en australia)
triceps	triceps
tableware	cubiertos
macrocosm	macrocosmo
abusable	abusable
idea	la idea
overpopulated	superpoblado
backing	apoyo
tarot	tarot
lovely	adorable
figure	figurar
magicians	magos
damsel	doncella
airway	(breathing) vía aérea
consumption	consumo
calories	calorías
passports	pasaportes
backstitching	pespuntear
telepathic	telepático
hazel	avellanado
stone	la piedra
zest	la vivacidad
baffling	confundiendo
gynecologist	ginecólogóa
sack	saco
streets	las calles
tested	examinó
cameramen	camarógrafos
hack	cortar; tajar
inches	pulgadas
children	niños
road	el camino
review	el repaso
strategically	estratégicamente
weather	el tiempo
transatlantic	transatlántico
nobody	nadie
calculatedly	calculadamente
natural	naturalis
internality	internalidad
cancellations	cancelaciones
idem	ídem
quagmires	pantanos
tranquillity	tranquilidad
leaflets	los libritos
laconize	lacónizar
thingamajig	cachivache
totalitarianism	totalitarianismo
necklaces	gargantillas
laborious	tabajoso
quadraphony	cuadrafonía
flag	la bandera
racing	carreras
seasonal	estacional
lacunar	lagunar
acidimeter	medidor de acidez
abdicator	abdicador
calamitously	calamitosamente
televiewer	televidente
feature	facción
flat	plano
lacunae	lagunas
transcendentalists	trascendentalistas
occupying	ocupando
blouse	la blusa
gymnastics	gimnasia
suggest	sugerir
iconoclastic	iconoclástico
naphtha	nafta
token	peaje
cease	cesar
fanaticism	el fanatacismo
lagomorph	lagomorfo
abjuration	abjuración
thespians	artistas
argument	el argumento
cameraman	camarógrafo
abrading	raspando
dozen	la docena
tremendous	tremendo
televisors	televisores
stoplight	la semáfora
oceanologic	oceanologico
teammates	compañeros de equipo
tab	teddy
tad	nñno
tycoon	magnate
trapezoids	trapezoides
tag	etiqueta
campfire	fogata
saga	saga
abounded	abundó
notebook	el cuaderno
symposiums	simposio
tan	tostado
centuries	siglos
alarmed	alarmado
bitch	perra
filed	archivado
ugly	feo
radiobiologic	radiobiologico
tax	impuesto ( as in irs)
barbaric	barbario
safe	salvo
destined	destinado
teleprinter	teleimpresora
checkmate	jaquemate ( chess)
sail	vela
cab	taxi
balls	bolas
seasoned	sazonado
factional	faccioso
flea	la pulga
abjectly	abyectamente
can	lata
hair	el pelo
cap	el gorro
filthy	cochino
car	el coche
cafes	cafés
cat	gato
limitless	sin límites
stove	la estufa
thematically	temáticamente
alarm	alarma
bafflement	confusión
cay	cayo
village	el pueblo
cabins	cabinas
smooth	liso
ultimatum	ultimatum
racism	racismo
rainfall	la lluvia
overcoat	el abrigo
motion	movimiento
pussycat	minino
wastebasket	basurero
abhorrer	la persona que odia
balmy	suave
hail	alabar
clothes	la ropa
poetical	poética
abhorred	aborrecido
racist	racista
