islam 	islam
helado	glace
sudáfrica  ; áfrica dsur s	afrique du sud ; république d’afrique du sud ; république sud-africaines
cafetería	cafétaria
cablegramass	câblogrammess
pizza s	pizzas
característica	trait
conformes	conformités
carcinógeno	cancérigène
plático	plastique
mejors	mieux ; meilleurs
chinears	choyer, dorloters
viena 	vienne
abandonado	dévergondé
pasquas	pâquess
cumpleaños	anniversaire
equipaje	effets
tayikistán s	tadjikistans
cocina	cuisine
huevo	oeuf
ventana	fenêtre
anormalmente	anormalement
piyamas	pyjama
teóricoss	théoricienss
arsénico 	arsenic
acidos	acides
acetaminoféns	acétaminophèns
goma	caoutchouc
poquitas	délicats
lípido	lipide
matadero (gb)s	abattoirs
padre	père
pies	pieds
piel	peau
por accidentes	accidentellements
veróns	hommes
iñ en desuso	en suspens
aceleración	accélération
europio 	europium
sals	sel ; sel de table ; sel alimentaire ; sel de cuisines
verbos	verbes
abandonando	abandonnant
estación	gare
puntos	points
triángulo	triangle
o	ou
brujas	sorcières
pinturass	couleurss
sala	chambre
rojo	roseau
abolir	en train de bouillir
y	et
obedecers	obéirs
obeso	obèse
gracioso	plaisant
vivacidads	piquants
sermóns	sermonss
erbio 	erbium
sojuzgars	jougs
características	trait ; characteristiques
teherán 	téhéran
abuelo	grand-père
fumars	fumées
satisfecho	satisfait
haciendas	ferme (exploitation) ; fermes
terbio 	terbium
los pinoss	pinss
viajar ( to trav)	voyager
adj & n  - adulto -ta (mf)	adulte
top/o	tamia
absorbente[]	absorbant
sans	saints
átomo 	atome
saboteados	sabotés
saboteador	saboteur
acuarium	aquarium
creers	croires
chicos	garcons
arcil ; barro s	argiles
macroinstrucción	macroinstruction
policías	policiers
bondads	gentillesses
concursos	contesters
cuchara	cuiller
venezues	venezuela ; vénézuéla ; vénézuélas
mega-bytes	mégaoctets
helados	glaces
regalo	cadeau
obra maestra (chef d'oeuvre)	d'oeuvre
venenos	poisons
bacterias	bactéries
documentacións	documentations
almas	âmes
muertes	morts
puerco	cochon
avergonzar 	confondre
antagonismo	antagonisme
bromo s	bromes
bucarests	bucarests
axi ; sobaco s	aisselles
abismo	abîme
cortados	abbrégés
bactericida	bactéricide
cbalístico(a)s	cabalistiques
ausente; 	absent
balbuceadors	bavardents
cactos	cactuss
adverbio	adverbe
en camas	au lits
clorófilo	chlorophylle
longitud	longitude
traducir	traduire
abjuración	renoncement
nigeria 	nigeria
acidez	acidité
realidads	faits
mejor	mieux
asia 	asie
toronja	le pamplemousse
realismos	réalismes
humillandos	humiliants
curio s	curiums
comunicacións	communication
cantors	chanteurs
los hombres	hommes
ardiente	en feu
faccion	faction
carbóns	charbon de boiss
academiass	academiess
nueves	neufs
kioskos	kiosques
cerdo hormiguero	adverbe
calcios	calciums
domicilios	demeures
dormido	endormi
sangre	sang
abolicionistass	abolitionnistess
población	population
clarinete s	clarinettes
semilla	semence
gonorrea 	blennorragie
leyendo	relevé
cebras	zèbres
absceso	abcès
matemáticas 	mathématiques
tacómetros	tachymètres
intérprete 	interprète
hacer	faire
mezcolanza	mélange
leyenda	legende
besar	embrasser
frutas	fruits
jabón s	savons
cucarachas	cafards ; cafards
travesaño	registre
cafeterías	cafétarias
poner	mettre
mesas	tables
loves	aimers
calibre	calibres
objeción	objection
tejidos	tissus
minutos	minutes
teológicos	théologiques
cromatografías	chromatographies
ancs	ancres
próspero año nuevo ; feliz año nuevo s	bonne années
rosa	rose
ausente	absentee
galio s	galliums
plumas	plumes
col	chou
capital	capitale
con	avec
escoba	balai
cerveza	bière
pesquero(a)	pêche
jornaleross	les ouvrierss
remos	rames
longituds	longitudes
indicacioness	affichagess
empaquetado	paquet
nacionals	nationalés
compendio	résumé
academia	académie
flúor s	fluors
animal domésticos	animal domestiques
aboriginalmentes	aboriginalements
pipa	tuyau
facilidads	usine, établissements
cumplidos	accomplirs
tenedors	fourchettes
acacias	acacias
hiena 	hyène
helios	héliums
abstenerse des	renoncers
pintura	peinture
promecio s	prométhium ; prométhéums
acompanistass	accompanistess
liberalismo	libéralisme
pacifismo	pacifisme
olvidadizos	distractions
próstata	prostate
rostros	face ; figure ; visages
teluro s	tellures
abdicado (participio de abdicar)s	abdiqués
salado	salé
blancos	blancs
chingados	foutus
malogrado	raté
islam s	islams
predicadores	prédicateurs
traduccións	traductions
ciudads	villes
alfil  ; arfil s	évêques
abniegas	renie, répudie, rejettes
electrón s	électrons
tarjetas	cartes
puentes	ponts
fuga	fugue
ábaco	abaque
adiestrador ( military)	encadreur
accedido	accessé
clasificación periódica  ; tabperiódica s	tableau périodique ; tableau périodique des élémentss
acompañar	accompagner
oceanos	oceans
acompañas	accompaniess
las comidass	repass
torio s	thoriums
arrozs	riz ; grain de riz ; grain de rizs
ovejas	moutons
equivocación	aberration
bacilo	bacille
los perross	chienss
eneros	janviers
necesitars	besoins
langosta	locuste
doctor	docteur
saliva	salive
celibato	abstinence
aboles	abolit, abroge, supprimes
garajes	garages
sri lankas	sri lankas
mendelevio s	mendéléviums
abandonars	abandonnes
cantor	chanteur
cuidados	cares
cabinas	cabines
desierto	désert
caballos de carreras	cheval de courses
wikipedias	wikipédias
habitantes	habitants
yoga s	yogas
teocrático	théocratique
semanas	semaines
lee	lires
fósforo s	phosphores
tumbar	démolir
cromosóma	chromosome
frios	froids
tus	vouss
máquinas[]s	machiness
proyectar	prévoir
hadas	fées
ajenjos	absinthes
aditivo )adj & noun)	additif
proyectas	envisages
sadistas	sadistes
golf s	golfs
calcetín  (chile'el salvador'guatemala'honduras'mexico'nicaragua'spain), media  (costa rica'cuba'panama'puerto rico'south america except chile)	chaussette
astronomía s	astronomies
ballet	ballet
inteligencia; cabeza	cerveauxs
alondra 	rossignol
moldavia s	moldavies
net(red)s	rs
animal doméstico	animal domestique
chimpanc/es	chimpanzés
cigüeña s	cigognes
teddys	sortirs
cerámicas	céramique
reloj	horloge
aceleracioness	accélérationss
abominar	abhorrer
distraidamentes	distraitements
document	document
cirujano	chirurgien
fuentes	fontaines
dolor de orejas	mal d'oreilles
toronjas	le pamplemousses
índice 	index
hormigas	fourmis
bioquímica 	biochimie
canadá 	canada
penínsus	péninsules
amarillando	jaunissant
abrasibles	qui peut s'érafler, qui peut s'éroders
cadete	cadet
arból	arbre
acetonas	acetones
en ausencias	distraitements
desear	désirer
burkina faso	burkina faso
humillación	humiliation
dolorosamentes	douloureusements
caballero	chevalier
ablución	ablution
tecnecio s	technétiums
meditar	méditer
economicas	econom'icas
domicilioss	demeures, domiciless
pacifista	pacifiste
eyaculación s	éjaculations
barbilla	feuillure
macroestructura	macrostructure
pezones	tétons
acelerímetros	accéléromètres
balcon	balcon
entregar	accoucher
asia s	asies
tulio s	thuliums
cebada s	orges
platas	argents
nietos	petit-filss
medalla	médaille
terminados	accomplis
renunciar	abjurer
namibia	namibie
brusco (sudden); áspero (curt)s	abruptes
quillas	la quilles
puntillista	pointilliste
preposición s	prépositions
raqueta (for tennis)	tumulte
pagados	payés
leches	laits
racistas	racistes
dalmatass	dalmatienss
energía s	énergies
presidentes	présidents
precio	prix
aniversarios	anniversaires
habitantess	habitantss
lutecio 	lutétium
ovario 	ovaire
las manos	mains
vendedors	un vendeurs
pintoress	peintres
turkmenistán 	turkménistan
puerta	porte
vendedor	un vendeur
soñars	rêvers
equipajes	effets, coliss
solteross	célébatairess
fogón; cocina	caboose
baladas	ballades
yihad s	luttes
laboratorio	laboratoire
curio 	curium
séptimo , séptima  ; (abbreviations) 7º , 7ª )s	septièmes
abreviar	abréger
naranjas	oranges
profesión	carrière
aprenders	apprendres
conocidos	connus
fabricantes	fabricants
maceraciones	mace'rations
bambús	bambous
abrogar	abroger
(ethnicitys	courses
pluma	plume
clima	climat
karate	karaté
[off] masturbarse	valet
carbón	charbon de bois
de manera macabra	macabrement
polarizados	polarisés
dondes	oùs
bien	puits
macroevolucion	macroe'volution
abstinentamente	sobrement
asistirs	s'occuper des
atraers	vêtirs
nubes	nuages
ardientes	en feu, en flammess
teorias	théories
gabinetess	cabinetss
anormalidadess	anomalies, difformitéss
tejo	if
pans	pains
champaña	champagne
cobalto s	cobalts
química	chimie
planeta	planète
abjura	abjurers
chimeneas	cheminées
antropologo	anthropologue
cometa	cerf-volant
accidental	accidentel
dolor	douleur
facilmente	facilement
enseñar	enseigner
quehacer ( chore)	tâche
cerámicass	céramiques
químico	substance chimique
sureste asiático 	asie du sud-est
periódico 	journal
macaco	macaque
dificultad	difficulté
absentas	absinthes
arado 	charrue
palacios	palaiss
vt - ajustars	ajusters
(comparativo) más capaz/hábils	le plus compétents
lecturas	lectures
puntillismo	pointillisme
arma s	armes
secuestrador	adducteur
palurdo	nigaud
sonido 	son
alegría  ; gozo  ; felicidads	joies
cafeínas	caféine ; théines
agregar; (arith) sumar	summata
miel	miel
territorio	territoire
monturas	 une selle
barbadoss	barbades
dormirs	dodo ; repos ; sommeils
abortados	avortés
comers	mangers
anarquismo 	anarchisme
anormalidades	anomalies
alb"ó"ndigass	boulettes de viande
mina 	mine
oasis	oasis
trapo (piece of cloth)	chiffon
diario	journal
delantal	tablier
castillo	château
costars	coûts
alcoholismo	alcoolisme
transacciónes	transactions
medusa	meduse
y comercial 	et commercial
setentas	soixante-dixs
avergonzado	deconcerte
indio s	indiums
maceracioness	mace'rationss
atento	attentif
pastels	tartes
macromoleculass	macromole'culess
zona	zone
papa	pape
cuadros	images
papi	papa
ensaladass	saladess
miels	miels
desiertos	déserts
páginas	pages
diciembre	décembre
brasil 	brésil
criptón 	krypton
prestar atención	avis
fácil	facile
orquestas	orchestres
cantar	chanter
pascua 	pâques
perdonador	indulgent
tristementes	tristements
macromoleculars	macromole'culaires
ochos	huits
neerlandés	néerlandais
cumpleañoss	anniversaires
bandido	brigand
folleto	brochure
malísimamente	abominablement
macrocosmo	macrocosme
pars	couples
acuerdo	accord
accidentes	accidents
sastres ( noun)	tailleurs
bazo s	lien ; rates
misterioso	mystérieux
planchars	fers
parís 	paris
anarquismo s	anarchismes
sotavento	côté
radios	radios
páncreas 	pancréas
alojamiento	accomodation
galope	galloper
besos	bisous
osmio 	osmium
economica	econom'ica
cableado	cablé
antónimo s	antonymes
gas lacrimógenos	gaz lacrymogènes
nicaraguas	nicaraguas
asasinoss	des tueurss
gerencias	gestions
en cama	au lit
oceanografia	océanographie
miserable (poverty); rastrero (apology)	abject;
fabulistas	fabulistes
humillaciones	humiliations
barbados	barbade
américa dsur 	amérique du sud
truenos	tonnerres
tiroide	thyroïde
renuncia; abdicación (de un monarca)s	abdications
nobelio 	nobélium
doss	deuxs
mágicos	magiques
flauta 	flûte
amenaza s	menaces
cantidads	quantités
latas	étains
luz	lumière
haréms	harems
de sers	d'êtres
des	environ, a peu press
estratégicos	stratégiques
de travéss	par le traverss
pato	canard
política 	politique
base de datos	base de données
presidente	président
absurdismo	absurdisme
orejas	oreilles
pekín s	pékins
zorro	renard
grato	souhaiter la bienvenue à
vidrio	verre
abandonados	dévergondés
tiroides	thyroïdes
meditacioness	méditationss
paso	vitesse
abrasivos; bruscos (manner)s	abrasifss
oceano	ocean
cuarto 	quartier
contemporáneos	de la même générations
dalias	dahlias
quesos	fromages
base de datoss	base de donnéess
pasillo  ; corredor s	corridor urbains
barcos	bateaus
abniega	renie
tailandia s	thaïlandes
pavo	dinde
absortos	absorbés
danés s	danoiss
hacers	faires
arquitectos	architectes
medieval	médiéval
julios	juillets
paladio s	palladiums
ayudars	aides
aceders	consentirs
pasillo 	corridor urbain
macroencefalico	macroce'phale
azuls	bleus
aluminio 	aluminium
tristezas	tristesses
lingüística 	linguistique
tierra	terre
ponderosos	pesants
juegoss	jouess
nube	nuage
laberinto	labyrinthe
aplacados	a diminués
verano	été
xenofobia s	xénophobies
ballets	ballets
protactinio s	protactiniums
enemigo 	ennemi
nuez	la noix
macarroness	macaroniss
abogado	avocat
trompeta 	trompette
legal	legal
aceleradores	accélérateurs
senegals	sénégals
manganeso 	manganèse
lloras	pleures
llorar	pleurer
exitos	réussités
dulce de chocolates	sucre a` la cre`mes
teta	trayon
cremas	crèmes
consumo	consommation
sinfonías	symphonies
senderos	sentier pedestres
sacrilegio	sacrilège
cerdos hormigueros	tamanoirs
política s	politiques
aborto (acción)	avortement
sacrificados	sacrifiers
fiels	fidèles
machete	machette
cabotaje	cabotage
sabers	sait
polarizar	polariser
habitaciones	demeures
polvo s	poussières
los terremotos	séisme ; tremblement de terres
bolsass	fouilles, étuis, sacss
abrasioness	écorchures, égratignuress
titanio 	titane
pazs	paixs
lunas	lunes
tress	troiss
señoritass	mesdemoiselless
pretéritóparticipio pasado de have	se faire avoir
tumbars	démolirs
en sentido de las agujas dreloj	dans le sens des aigüilles d'une montre
religión 	religion
lengua	langue
uni	chaux
paramentos	face a, en face des
uno	un
uns	uns
radón s	radons
iñ en desusos	en suspenss
teologías	théologies
dieciséis s	seizes
saber	savoir
coches	voitures
moscú 	moscou
joyas	joyaux
diecisiete	dix-sept
lóbulos	lobe d'oreilles
padress	papass
terroristas	terroristes
loco	fou
terminado	accompli
lobo	loup
chacales	chacals
abismoss	abîmess
durezas	duretés
argón s	argons
naranja	orange
punto	point
banco	berge
jardineros	jardiniers
marcapasos	stimulateur cardiaque
útil	utile
legítimo	régulier
dulces	douxs
gas s	gazs
vanadio 	vanadium
curso	cours
contento	contentement
reajustas	réajustes
reajustar	réajuster
server	serveur
facials	facials
macroencefalicos	macroce'phales
desde allí	pour cette raison
dos	deux
amenazandos	menacants
tosers	toux
batracio ( animal)s	crapauds
mago	magicien
magistratura	magistrature
geografía s	géographies
cincos	cinqs
efectos	effets
alojandos	obligeants
aceros	aciers
lunes	lundi
academicamente	académiquement
banda	insigne
rutherfordio s	rutherfordiums
mar	mer
aceptadores 	accepteurs
menosprecio	mépris
abates. no abades.s	abbéss
piedras	pierres
libro de bolsillos	livres de poche
extranjero	étranger
rumania 	roumanie
sabio	sage
acordeonistas	accordionists     accordionistes
orina s	urines
transferencia ( noun)	transfert
besoss	bisouss
abortante	avorteur/ avorteuse / faiseuse d'anges
aberrantementes	de façon aberrantes
nobelio s	nobéliums
odiosos	odieuxs
avestruz s	autruches
frentes	devants
abióticos	abiotiques
astato s	astates
poblacións	populations
lubricante	lubrifiant
acidificacións	acidifications
bellota	gland
azúcar s	sucres
libro	livre
sastres ( noun)s	tailleurss
dromedario 	dromadaire
vagina	vagin
pingüino s	manchots
acanto	acanthe
adición	addition
acompañante	accompagnateur
ferrocarril 	voie ferrée
impuesto ( as in irs)	taxe
políticas	politiques
juventuds	jeunesses
animes	animes
sastre ( noun)	tailleur
acreditadación	certification
jartum s	khartoums
vampiro	vampire
xenofobia 	xénophobie
aguiluchó l'aiglon (aguilucho)	aiglon
espinazos	épines
pesoss	série de poidss
acordeoness	accordéonss
absorbe	absorber, retenir, assimilers
poners	mettres
mes	mois
oligarquia	oligarchie
uva	raisin
hassio s	hassiums
yuppies	yuppies
cubierta	couvrir
aunque	quoique
espaldarazos	accolades
octubres	octobres
tabacos	tabacs
transferencia ( noun)s	transferts
kétchup 	ketchup
macarrones	macaronis
radiologías	radiologies
extranjeros	étrangers
acostumbrados	usuels
arrodillarses	s'agenouillers
anime	anime
rabinos	rabbins
conocimiento	le savoir
maquinariass	machineries
políticos	politiques
brusco (sudden); áspero (curt)	abrupte
pepinos	concombres
celos	zèles
ascensor	ascenseur
absorto	absorbé
verdaderos	vrais
acompanistas	accompanistes
indio 	indium
los perros	chiens
tiempos	tempss
septiembres	septembres
velas	les voiles
radars	radars
hielos	glaces
malo	mauvais
corcho	liège
esqueleto s	squelettes
raqueta (for tennis)s	tumultes
tacómetro	tachymètre
instigador	aide
nevera	réfrigérateur
hidrógeno s	hydrogènes
alondra s	rossignols
azafrans	le safrans
cubiertas	couvrirs
empaquetars	emballages
absentismos	absentéismes
animal	animal
disprosio 	dysprosium
producto lácteo	laitier
colass	queuess
safari	un voyage
las medias	garder en stocks
lóbulo	lobe d'oreille
celular ( anglicism)s	cellulaires
odioso	odieux
actitud	attitude
energía 	énergie
mil	mille
cábala	cabale
abstinencias	abstinences
cacaos	cacaos
tailandia 	thaïlande
accesorio	accessoire
lomo	épine
desnutricións	malnutritions
seaborgio 	seaborgium
absolvers	exonérants
setenta	soixante-dix
lágrimas	larmes
mano	main
abundantementes	abondamments
alud  ; avalancha s	avalanches
gordos	gross
las lámparas	lanternes
pacificos	pacifiques
diass	jourss
todos los dias	quotidien
wikcionario 	wiktionnaire
paleontología	paléontologie
alojado	accommodé
respaldo	sauvegarde
arrancalágrimass	mélos
octavo , octava  ; (abbreviations) 8º , 8ª s	huitièmes
obesidads	obésités
lagarto	lézard
fabrica	tissu
medievals	médiévals
finlandés  ; finés s	finnoiss
laceracioness	lacérationss
aceituna	olive
arena	sable
(of the alphabet) letra	caractère
lenguas	langues
ananá	ananas
kilómetros	un kilomètres
ahoras	maintenants
matars	tuers
abstrusos	abstruss
precipitacións	abruptes
obelisco	obélisque
iglesias	églises
nigeria s	nigerias
diecinueve	dix-neuf
pacificaciones	pacificateur / -trice 
de arte	d'art
triunfos	accomplissements
teocráticos	théocratiques
hafnio	hafnium
tanzania 	tanzanie
pegar	frapper
mamá	mère
estroncio s	strontiums
pintar con laca	laque
manzana	pomme
herida  ; lesión s	blessures
narizs	nezs
tren ( noun) adiestrar ( military)	train
acidezs	acidités
cómplicess	complicess
ebanister/ia	ébénistes
escaparse	s'enfuir
abrogacíon	abrogation
tortas	gâteaus
accesores	accesseurs
calabacín	courgette
neón 	néon
ratón	souris
mapa	carte
uranio s	uraniums
guitarra	guitare
cadmio	cadmium
acomodar	accomoder
saltar	sauter
geometría	géométrie
bachillerato	baccalauréat
morós	souffris
trigo 	blé
espada s	épées
los ojos	œil ; yeuxs
feos	laids
gasolina  s	essences
pollo	poulet
alquitranados	macadamisés
polémicos	polémiques
biens	puitss
mónaco 	monaco
cálculo	calcul
caminos	routes
holas	bonjours
petróleo 	pétrole
activista	activiste
californio	californium
arrendajo , urraca 	geai
mars	mer ; mers
gustó	goûté
político 	politicien
anualmentes	annuellements
alud 	avalanche
documentación	documentation
dolor de espalda	douler de dos
colesteról	cholestérol
abolidos	abolis
dolors	douleurs
continentes	continents
sudán s	sudan ; soudans
turquía s	turquies
locos	fous
jardines	jardins
michaels	prenomss
los cigarros (mex)	cigarettes
ganancia	gagner
mineralogía 	minéralogie
premio máximos	gros lots
aacidentalista	accidentaliste
escribe	écrires
machos	machos
hacienda	ferme (exploitation)
cortar	couper
arriba citados	mentionné ci-dessuss
abusivo	abusif
artilugio	un gadgets
sociedad	société
abortado	avorté
aranas	araignées
consejo	bon de livraison
negros	noirs
carnes	viandes
ciencia	science
naturalis	naturel
cintas	dentelles
avance	avance
jovencito	jeune
olvidos	manque de mémoires
embarazo s	grossesse ; gestations
policía	policier
juvenil	juvénile
aceptaciónes	acceptations
love	aimer
clorófilos	chlorophylles
gordo	gros
rumania  ; rumanía s	roumanies
los labios	lèvres
electricidads	électricités
aberrantemente	de façon aberrante
rapidamentes	rapidements
papúa nueva guinea 	papouasie-nouvelle-guinée
antónimo 	antonyme
senda	sentier
yogur s	yaourts
amenazando	menacant
europa	europe
gusto	goût
chacal	chacal
acostumbrado	usuel
dolor de espaldas	douler de doss
deudas	dettes
abstracción	distraction
terminars	se calme
dañando	endommageant
océano pacífico 	océan pacifique
diente de leon	pissenlit
nitrógeno s	azotes
jartum 	khartoum
cesio 	césium
tintas	encres
berlín s	berlins
cromosómas	chromosomes
áfrica 	afrique
volcán 	volcan
testósterona	testostérone
litio 	lithium
past of do.	a fait
muertos	morts
eco	écho
adioss	au revoirs
polvo	poudre
mayo	mai
vacíos	vides
hunter	chasseur
alcachofa	artichaut
física s	physiques
patos	canards
cartografía	cartographie
ver	voir
abortando	discontinuant
embajador	ambassadeur
fabricars	fabrique
vocabulario	vocabulaire
abdicadors	abdicateurs
gemelos	jumeaus
este	est
acnés	acnés
gallinas	poules
sodio 	sodium
preguntas	questions
crimens	crimes
velocidad	vitesse
mortalidads	mortalités
alojamientoss	accommodationss
suprimir	abroger
jade	jade
lámparas	lampes
abiyáns	abidjans
quieto	tranquille
faccions	factions
abejorro 	bourdon
crucigrama s	mots croiséss
aprender	apprendre
estuches	boiîte à thés
balbucears	bavards
dientes de león	pissenlits
aborreciente	abhorrant
de estado	d'état
jardín zoológicos	zoos
sonrisas	sourires
hacia atrás	déconcerté
ruegos	prières
grava	gravier
abole	abolit
suertes	chances
francia	france
taiwáns	taïwans
enseñars	enseigners
dieciséis 	seize
fosa  ; foso s	fosséa
veneno	poison
mazo	sceptre
calidad	qualité
cebo	leurre
lawrencio 	lawrencium
y comercial  ; s	et commercial ; esperluettes
jamaica 	jamaïque
arriba citado	mentionné ci-dessus
juevess	jeudis
alfabetos	alphabets
pepino	concombre
colas	colles
cuadernos	copy books
algodón 	coton
vil	méprisable
conferensistas	conférenciers
permiso	autorisation
abismal	épouvantable
obediencia	obéissance
acordeón	accordéon
febrero	février
doctrinas	doctrines
abundandos	abondants
dictados	dictés
aborto	faire avorter
grajillas	choucass
insecto	insecte
hígadoss	foies
cesio s	césiums
armenia s	arménie ; république d'arménies
mayos	mais
fardo	ballot
dictars	dicte
orgasmo s	orgasmes
actituds	attitudes
vacuna	vaccination
burkina fasos	burkina fasos
humillar	abaisser
calcio	calcium
catástrofes	catastrophes
mega-byte	mégaoctet
sonrisa	sourire
paleontologías	paléontologies
lawrencio s	lawrenciums
cadencia ( musical)	cadence
accidentals	accidentels
doument	tête
emiratos árabes unidos s	émirats arabes uniss
pulpo 	poulpe
wikipedia	wikipédia
de través	par le travers
ornos	four de cuisines
pasado	passé
catarata	cascade
yugoslavia 	yougoslavie
galopes	gallopers
gabinetes	cabinets
glaciar s	glaciers
abusivos	abusifs
estréss	stresss
absolver	absoudre
habilitados	habilités
ayud/os	encouragea, soutients
sagacidads	la sagacités
paganos	païens
puño 	poing
obedientes	soumiss
talentos	competence; capacite;s
reinas	reines
mañanas	demain ; lendemains
deporte	sport
taxis	taxis
drogas	médicaments
plomo	plomb
tradicional	traditionnel
deportes	sports
bosques	forêts
melón 	melon
las ananáss	ananass
níqu	nickel
ruego	prière
océano ártico 	océan arctique
locomotora	locomotive
brazo	bras
amarillos	jaunes
humedos	humides
embajadors	ambassadeurs
borde	rebord
cabalistas	cabalistes
escarabajo 	coléoptère
abandono	abandonnement
gravas	graviers
niño	enfant
canadá s	canadas
octavo , octava 	huitième
donde	où
educación 	éducation
lava volcanica	magma
clóro	chlore
jamaica s	jamaïques
aeropuertos	aéroports
rabiosos	enragés
mozos	garçon ; serveurs
tetass	tettess
montura	selle
sacrilegios	sacrilèges
fermio 	fermium
criptón s	kryptons
abril	avril
acelerado	accéléré
gonorrea s	blennorragie ; gonorrhées
trayectoria	trajectoire
mora 	zarzamorra
ajenjo	absinthe
perdonars	pardonne
sinfonía	symphonie
secuestross	enlèvementss
américa dnorte s	amérique du nords
abrasivos; bruscos (manner)	abrasifs
mamás	mères
bagatelas	bagatelles
ovario s	ovaires
caviárs	caviars
europa occidental s	europe de l'ouests
cabra  ; chivo s	oies
secretos	secrets
acacia	acacia
huevos	oeuf ; œufs
próspero año nuevo	bonne année
apaticos	nonchalants
eslovaquia 	slovaquie
tetas	tettes
ohms	ohms
paquete	paquet;ballot
coche	voiture
bolsillos	poches
misteriosos	mystérieuxs
harém	harem
nadies	personnes
agua	eau
galaxia	une galaxie
caspa	pelicule
yuppie	yuppie
empaquetandos	emballages
chingado	foutu
cangrejo	cancre
neptuno 	neptune
químicas	chimies
nicaragua	nicaragua
lubricantes	lubrifiants
contabilidads	comptabilités
aborigeness	aboriginess
chacaless	chacauxs
mar caspio 	mer caspienne
ceja	sourcil
entrars	entrers
mónaco s	monacos
cosers	coudres
tabajosos	laborieux, laborieuses
 caballo de carrera	cheval de course
ochenta	quatre-vingt
criaturass	bébéss
cereza	cerise
cómplice	complice
celo	zèle
abominars	abhorrer, exécrer, abominers
cueros	cuirs
américa dsur  ; sudamérica  ; suramérica s	amérique du suds
gasolinas	essences
regalos	cadeaux
rutherfordio 	rutherfordium
teluro 	tellure
circonio 	zirconium
religión s	religions
aditivos	additifs
caleidoscopios	kaléidoscopes
pianos	pianos
rabias	rages
calendario	calendrier
abads	abbés
permisos	autorisations
estes	ests
moras	tolère, demeure, subsistes
camions	camions
plomos	plomb ; saturnes
mansedumbres	soumissions
testósteronas	testostérones
abreviandos	raccourçants
pastor 	berger
colesteróls	cholestérol ; cholestérines
martes	mardi
pierna	jambe
burlonmente	pour taquiner
seaborgio s	seaborgiums
dañandos	endommageants
cable	câble
tabletillas	comprimés
hierbas	herbes
canals	canals
responsables	responsables
macrófago	macrophage
magistral	magistral
sacarosa	saccharose
abstinente	absteni
artropodos	arthropodess
talentoss	talentss
ventanas	fenêtres
enzimas	enzymes
balada	ballade
escribir	écrire
montaña s	montagnes
bachilleratos	baccalauréats
apio	céleri
desamparado	délaissé
coliflor	chou-fleur
aborigens	aborigènes
machismos	machismes
año	année
backups	sauvegardes
tradicións	traditions
amenazadamentes	d'un ton menacants
poquita	délicat
cocears	s'amuser
cablegramas	câblogrammes
media	garder en stock
toro	mâle
magistralmentes	magistralements
atraer	vêtir
molibdeno 	molybdène
mongolia 	mongolie
medio	médium
facilmentes	facilements
dureza	dureté
las joyass	joyauxs
antropologos	anthropologues
hogars	maisons
apreciar	reconnaissant
de frente: "to keep abreast of" (fig): mantenerse al corriente des	de fronts
serpiente  ; culebra  ; sierpe ; víbora s	serpents
ciervo 	cerf
salmón 	saumon
necesitar	besoin
flechas	flèches
museos	musées
anómalo	aberrant
sabotajes	sabotages
dislexia 	dyslexie
abortivamentes	en vains
calcetín  (chile'el salvador'guatemala'honduras'mexico'nicaragua'spain), media  (costa rica'cuba'panama'puerto rico'south america except chile)s	chaussettes
rabio	queue
dromedario s	dromadaires
cebollas	oignons
cabalista	cabaliste
venders	vendres
bahréin, bahráins	bahreïns
ecologias	écologies
s. descuentos	coupuress
amigos	copines
cuero	cuir
cocinas	cuisines
rabia	rage
la haya s	la hayes
hábitats	habitats
macadamizars	macadamise
distraído	distrait
rascacielos  ; torre s	gratte-ciels
barco	bateau
cero	zéro
past of do.s	a faits
vientos	vents
reinos	royaumes
antilope	antilope
caféss	café-restaurantss
dientes de leóns	pissenlitss
metal 	métal
enemigo s	ennemi ; ennemis
abbé=abate	abbé
alemáns	allemand ; allemand ; allemandes
abandonoss	abandonss
transcribir	transcrire
cáncers	cancers
activistas	activistes
incineradores	incinérateurs
piels	peaus
absentismo	absentéisme
abbé=abates	abbés
níqus	nickels
silla	chaise
los terremotoss	tremblements de terres
yeso	craie
tinta	encre
lisboa 	lisbonne
abismos	abîmes
magnesio	magnésium
desvíoss	erreurss
perra	chien
instigando	provoquant
incinerador	incinérateur
pintar con lacas	laques
atenas 	athènes
yegua 	jument
propenso	prompt
kilates	carats
estroncio 	strontium
cenits	zéniths
gas lacrimógeno	gaz lacrymogène
desde entonces	dès lors
tercos	invétérés
mágico	magique
dependienta	une vendeuse
juntos	ensemble
diecisietes	dix-septs
dependiente	un vendeur
manchar	maculer
absolutismo	absolutisme
domingos	dimanches
clasificación periódica 	tableau périodique
absoluto	absolu
tiburón s	requins
documents	documents
suprimirs	abroger, supprimers
venuss	vénuss
rodillas	le genous
paramento	face a
aborrecientes	abhorrants
baile	danse
antártidas	antarctiques
amarillo	jaune
aligátor 	alligator
mensajes	messages
antropologia	anthropologie
n - (to the hospital) adnision -f (accent over the   o); ingreso	aveu
pronosticars	prévisions
desdeñosos	méprisants
acuerdoss	accordss
gomas	caoutchoucs
pintars	peintures
glaciar 	glacier
organismo s	organismes
tránsitos	trafics
humedo	humide
estrellas	étoiles
disputas	luttes
yarda	yard
carnicero  ; carnicera s	bouchers
fácils	faciles
transmitir	transmettre
abdominal	abdominal
sin brillos	ternes
desvíos	erreurs
fuerza s	forces
repentinamente (leave); bruscamente (speak)s	brusquements
macabro	macabre
ayer	hier
dalmatas	dalmatiens
pacificación	pacification
los músicos	musiciens
temblar	trembler
legals	legals
caspas	pelicules
levadura	levure
nos	ne pass
dubnio 	dubnium
aún	encore
sri lanka	sri lanka
semillas	semences
gales	pays de galles
einstenio s	einsteiniums
coraje  ; valor s	courages
almendra	amande
dentados	e'bre'ches
(ethnicity	course
memorias	mémoire, souvenirs
galio 	gallium
relojs	horloges
portugal s	portugals
polígono s	polygones
rabino	rabbin
desposeidos	sans-abris
abadía	une abbaye
amistads	amities
gusanoss	vers de terres
abracadabra	abracadabra
polonia s	polognes
vender	vendre
zoología	zoologie
polaridad	polarity
aceleradoress	accélérateurss
amarilló	jauni
bostezos	bâillers
castor s	castors
las iglésias	églises
temblor	séisme
cacao	cacao
renuncia; abdicación (de un monarca)	abdication
terminar	s'apaiser
músico	musicien
chabacano	abricot
rabios	queues
música	musique
ausencias	absences
europa oriental 	europe de l'est
belgrados	belgrades
mirlo 	merle
plan	plan
barbarismo	barbarisme
sacerdotal	appartient a une chose religieuse
abstinentes	sobres
abnegación (autosacrificio)	abnégation
carbohídrato	hydrate de carbone
difamars	calumniers
raer	user en frottant
ecos	échos
acento	accent
menosprecios	mépriss
buenas noches  ; buenas tardes s	bonsoirs
pasar zumbando	aller en trombe
terápias	thérapies
tradición	tradition
organismo 	organisme
fabricante	fabricant
abrogacíons	abrogations
vuelo	le vol
chocolate	chocolat
atrasado	en arrière
acobardarses	cailles
acordeones	accordéons
nepal s	népals
chiflado; locos	barjots
separado de línea media dcuerpo.s	enlevés
útils	utiles
en suspenso	en attente
malasia s	malaisies
dias	jours
suecia 	suède
galas	un galas
pi ; batería s	batteries
abreviadors	abréviateurs
tornado	tornade
alfombra	tapis
manutencións	toujours
cangrejos	cancres
julio	juillet
abulóness	ormeauxs
baila	danses
afrikáans s	afrikaanss
miserable (poverty); rastrero (apology)s	abject;s
humillando	humiliant
lastres	ballast, lests
bufóns	dingues
serbia y montenegros	serbie-et-monténégros
praseodimio 	praséodyme
bazo 	lien
melón s	melons
abusos	abuss
las tierrass	terress
museo	musée
contabilidad	comptabilité
gustós	goûtés
jarra	secousse
pesas	poidss
droga	médicament
faisán 	faisan
boro 	bore
abismals	épouvantable, abominables
feo	laid
raja	bombe
fes	fois
las hojas	laissers
teólogoss	théologienss
sabático	sabbatique
absorbente	absorbant
gales ; país de gales s	pays de galless
abstinencia	abstinence
gasolina  	essence
tabús	tabous
sida 	sida
témpano	icebergs
vivacidad	piquant
algodón s	cotons
trigo s	blés
talón s	talons
fuerza 	force
sobrenivels	au-dessus du sol, à la surfaces
pino 	pin
dañados	endommagés
meitnerio s	meitneriums
orina 	urine
ladrillos	briques
aboriginalmente	aboriginalement
diez	dix
humillacioness	abaissements
las sillas	chaises
tacómetross	tachymètress
groenlandia 	groenland
probar	prouver
matadero (gb)	abattoir
macrófagos	macrophages
valle s	vallées
vacas	vaches
gatos	chat ; minous
surinam	surinam
muchachos	garçons
costa  ; litoral s	côtes
terápia	thérapie
dictado	dicté
vuelos	le vols
platino s	platines
fosa 	fossé
gala	un gala
almendras	amandes
guitarras	guitares
camello	chameau
fin	fin
(comparativo) más capaz/hábil	le plus compétent
secuestras	detourners
secuestrar	enlever
los chinos	chinois
acetificars	acetifiés
sagazmente	prudemment
sábado	un sabbat
rana	grenouille
tambor auditivo	tympan
suicidio s	suicides
sinagoga	synagogue
gente	gens
otoño	automne
encimas	au-dessuss
daliass	dahliass
condecoraciones	insignes
abstemios	frugal, sobres
alfabeto	alphabet
salmón s	saumons
en extranjero (to be); al extranjero (to go)	à l'étranger
perdonadors	indulgents
barros	vases
chiflado; loco	barjot
deprimentes	faiblants
tanzania s	tanzanies
bahía 	baie
peligrosos	dangereuxs
tifóns	typhons
nevar	neige
pantalón 	pantalon
machismo	machisme
abreviado	abrégé
rama	branche
búlgaro s	bulgares
acordeonista	accordionist     accordioniste
capítulos	chapitres
ba	balle
fin de semanas	weekends
sermonear	prononcer
tomate	tomate
algoritmos	algorithmes
chaqueta	veste
islas feroe 	îles féroé
tántalo 	tantale
balbucear	bavard
pingüino 	manchot
separando	enlevant
calibrado	calibré
múnich 	munich
vela	voile
peras	poires
gas 	gaz
justos	justes
alabars	grêles
magos	magiciens
granada s	grenades
equipos	accoutrements
sesentas	soixantes
fourtys	quatres
panaderia	boulangerie
asasinos	des tueurs
familias	familles
absorbente[]s	absorbants
salud	santé
oso polar  ; oso blanco s	ours blancs
roma s	romes
las brujass	sorcièress
teológico	théologique
neodimio 	néodyme
lutecio s	lutétiums
discursos	discourss
españa 	espagne
maestro	professeur
de	environ
urano	uranus
contadors	comptables
traers	apporter ; ameners
pinchazos	planters
vendas	bandages
pronosticar	prévision
macarrón	macaron
terrorismo	terrorisme
tungsteno 	tungstène
permitir	autoriser
acesible	accessibilité
reirses	rires
raro	étrange
top/os	tamias
tempranos	tôts
mapas	cartes
catástrofe	catastrophe
nariz	nez
llorosos	tout en pleurss
cigüeña 	cigogne
hechos	j'adores
niembre de mafia	mafieux
velocidads	vitesses
panaderos	boulangers
precipitación	abrupte
niños	enfants
ceniceros	cendriers
ceniza 	cendre
fe	foi
dubnio s	dubniums
junípero  ; enebro  ; ginebro s	genièvres
magistrals	magistrals
potasio 	potassium
dependientass	les vendeusess
muchacho	garçon
teológicamentes	théologiquements
abusivamentes	abusivements
eslovenia s	slovénies
mazass	masses
pulmón s	poumons
calibrar	calibrer
abolicionista	abolitionniste
venus	vénus
reincidir	régresser
muchacha	fille
olvidarses	oubliers
olvidadizo	distraction
lenguajes	langues
cucaracha	cafards
training centers	formations
costa dmar	littoral maritime
edulcorante 	édulcorant
municipalidad	commune
holmio 	holmium
gato	chat
pintar	peinture
profesións	carrières
precios	prixs
grul	grue
hebreo 	hébreu
sabotaje	sabotage
apios	céleris
cucharadita	cuillerée à café
equipo	accoutrement
heredero	héritier
repentinamente (leave); bruscamente (speak)	brusquement
cafeína	caféine
germanio 	germanium
vers	voirs
bailarín	danceur
aceptados	acceptés
riñón 	rein
aceptador	accepteur
estratégico	stratégique
barberos	barbiers
radaress	radarss
incineración	incinération
puntillisticos	pointillistes
dormitorio	chambre
maquinado	machiné
reno 	renne
ballena 	baleine
abominaciones	abominations
desempleo  ; paro s	chômages
sagazs	prudents
lomo (noun)	en arriere
anuarios	annuaires
ir	aller
carne	viande
neblinas	brouillards
coartada	alibi
alcoholismos	alcoolismes
cabalismo	cabalisme
abnegación (autosacrificio)s	abnégations
tejos	ifs
enojado	fou
potasio s	potassiums
espinacas	épinardss
lleno	plein
myanmar s	birmanie ; myanmars
dalia	dahlia
decirs	dires
pelícu	film
máquina[]	machine
literatura	littérature
garza 	héron
antropologias	anthropologies
teocracia	théocratie
gracias ; muchas graciass	remerciements
lectoress	lecteurss
artículo	article
anións	anions
samario s	samariums
selenio 	sélénium
estadísticas	statistiquess
abdicables	abdiquables
malísimamentes	abominablements
burro	âne
anormalidads	anomalie, malformations
dialecto 	dialecte
contender	lutter
suegra	droit
biblia 	bible
manteless	nappess
volcán s	volcans
taxistas	chauffeur de taxis
absuelto	exonéré
conejos	lapins
pláticos	plastiques
saturno	saturne
abundancia	abondance
rasga	larmes
ciegos	aveugles
viajar ( to trav)s	voyagers
bromo 	brome
tácitos	tacites
negocios	entreprises
liberalismos	libéralismes
accidentalmentes	accidentalements
querhaceres (chores)s	tâchess
mariquita	coccinelle
amenazar	menacer
lanas	laines
sadismos	sadismes
triunfo	accomplissement
salvo	coffre-fort
cráneo  ; s	crânes
polars	polaires
romper	larme
calcular	calculer
abulóns	ormeaux
efecto	effet
entre	entre
hábilmentes	de façon compétente, habilements
aceleraciones	accélérations
las langostas	locustes
delicados	plus délicats
reinoss	royaumess
bioquímica s	biochimies
meitnerio 	meitnerium
aplaudirs	acclamers
aborrecidos	avoués
azafran	le safran
rutenio 	ruthénium
ohm	ohm
faisán s	faisans
tiendas	boutique ; commerce ; magasins
café  ; tinto s	cafés
impuesto ( as in irs)s	taxes
liquidacion	solde
rodilla	le genou
no	ne pas
disprosio s	dysprosiums
espaldarazo	accolade
amenaza 	menace
biblioteca	bibliothèque
berkelio s	berkéliums
tendencia	tendance
oreja	oreille
escocia s	écosses
desnutrición	malnutrition
nombre	prenom
sabotajess	sabotagess
dolorosos	pénibles
hábil (skilled)s	capables
surinams	surinams
abandonos	abandons
coser	coudre
desviación	anomalie
conocimientos	le savoirs
codo	coude
mujer	dame
consejos	bon de livraisons
hélice	helices
terrorista	terroriste
criatura	bébé
responsable	responsable
os	ous
macromolecula	macromole'cule
montenegro	monténégro
cantars	chanters
lacayos (sirvientes)	laquaiss
cartero(a)s	facteurs
ojo	œil
sida  ; sida s	sidas
triunfoss	accomplissementss
pi	batterie
secuestros	enlèvements
anhelos	désirs
mineralogía s	minéralogies
comunismo s	communismes
adopción	adoption
filipinas s	philippiness
océano índico 	océan indien
sorpresas	étonners
ecologia	écologie
americio 	américium
político	politique
iglesia	église
oligarquias	oligarchies
totalmente (totally); ¡por supuesto (que sí)! (certainly!)	absolument
ladróns	voleurs
hebreo s	hébreus
seco	sec
encuestas	élections
rojos	roseaus
verón	homme
gruls	grues
salas	chambres
ganancias	gagners
bufón	dingue
ebanista	ébéniste
casis	presques
golf 	golf
macadamizar	macadamiser
paíss	payss
calibrars	calibrers
pesado	lourd
autorizados	accredités
taiwán	taïwan
interés	intérêts
arquitecto	architecte
nitrógeno 	azote
política	politique
placenta	placenta
daga	dague
tambien[conjunction]	aussi
sabáticos	sabbatiques
manchados	macule's
mar caspio s	mer caspiennes
peligro	danger
cabaret	cabaret
júpiter 	jupiter
bruselas 	bruxelles
neveras	réfrigérateurs
safaris	un voyage, en particulier en afriques
abstiene	abstenirs
ablacións	ablations
seds	soifs
si	oui
absurdo	absurdité
zorros	renards
yelmo	barre
caderas	flancs
cuidadosamentes	avec attentions
cristals	cristals
groenlandia s	groenlands
accidentalismo	accidentalisme
tendencias	tendances
irlanda dnorte	irlande du nord
abominable	abominable
avispa	guêpe
secuestradores	adducteur
diferente	différent
badminton	badminton
escuelas	école ; établissement scolaires
damas	mesdames
jicotea	tortue terrestre
rosados	roses
pacificadors	tétine, sucettes
pasqua	pâques
cucharaditas	cuillerée à cafés
esperars	espoir ; espérances
macacos	macaques
muñeca	poupée
seda	soie
anómalos	aberrant, egares
tu	vous
hongo	champignon
mango  	mangue
dentista	dentiste
lastre	ballast
dislexia s	dyslexies
celibatos	abstinence ; chastetés
herida 	blessure
planchar	fer
un	un
menors	plus jeunes
alturas	hauteurs
platino 	platine
cuadro	image
avións	appareil volant ; aéronefs
casco	casque
bailando	danser
sombra s	ombres
europio s	europiums
acreditadacións	certifications
acelerar	accélérer
obedecer	obéir
berlín 	berlin
pintor	peintre
años	années
zodiacos	zodiaques
mortalidad	mortalité
mango  s	mangues
descuentos	coupures
platano	bananes
tejoness	blaireauxs
seis	six
training center	formation
garaje	garage
aspirinas	aspirines
facetas	facettes
cola	colle
orno	four de cuisine
antagonismos	antagonismes
decisións	décisions
a bordo de	à bord
[off] masturbarses	valets
exito	réussité
madres	mères
electromagnetismo s	électromagnétismes
talón 	talon
abolicionismos	abolitionnismes
climatizars	acclimaters
órgano s	organes
cols	choux
accesos	accessions
terco	invétéré
germanio s	germaniums
abjuracións	renoncements
carnicero 	boucher
abundantes	abondants
acelerador	accélérateur
oro	or
acelerados	accélérés
amigo	ami
olvidarse	oublier
venda	bandage
rosas	roses
acantilados	falaises
pacifistas	pacifistes
gratos	souhaiter la bienvenue às
té	thé
recomendados	recommandations
ambulancia	ambulance
talento	competence; capacite;
químicos	substance chimiques
adj - adhesivo; ______ tape - teor cinta adhesiva	adhésif
sacos	piller
sesenta	soixante
vestidos	robes
dama	madame
dormitorios	chambres
lantano s	llanthane ; lanthanes
dificultads	difficultés
mezquita	mosquée
cadávers	cadavres
salir	laisser
ya	deja
aborrecer	avoir horreur de
oso	ours
arquitectura s	architectures
lecturass	lecturess
teológicamente	théologiquement
justo	juste
naturaliss	naturels
pavos	dinde ; dindons
húngaro 	hongrois
yo	j'
mina s	mines
tabernáculos	tabernacles
vitamina	vitamine
ys	ets
acesibles	accessibilités
combustibles	combustibles
babuínos	babouins
afrikáans 	afrikaans
cons	avecs
como	aimer
limóns	citrons
tiburón 	requin
frente	devant
libro de lecturas	lecteurs
comidas	aliments
absorcións	absorptions
musicals	musical ; performance musicales
fabricar	fabriquer
fabricas	tissus
oros	ors
raros	étranges
mora s	zarzamorras
abrroga	abrogers
estuche	boiîte à thé
ambulancias	ambulances
torio 	thorium
ecuación s	équations
receta	recette
bacarr/a	baccarat
hilos	fils
ambiente	environnement
medicinas	médecines
barbarismos	barbarismes
reyess	roiss
magistraturas	magistratures
abortista	avorteur
eyaculación 	éjaculation
ayudar	aide
comejéns	termitess
desayunos	petit-déjeuner ; repas du matins
acumulado	accumulé
balancear	bilan
dewaynes	sacrificess
casas	maisons
abolicíons	suppression, abolition, abrogations
sotaventos	côtés
oportunidad	hasard
séptimo , séptima 	septième
acompañantes	accompagnateurs
chabacanos	abricots
conserje	concierge
heridas	blessure ; plaies
sauce 	saule
cáñamo 	chanvre
mar mediterráneo 	mer méditerranée
roble	chêne
enzima	enzyme
lavar	laver
cobre	cuivre
abadíass	abbayess
aplacado	a diminué
de manera macabras	macabrements
silicio 	silicium
pezon	téton
inglés	anglais
contentos	contentements
llorars	pleure
orejass	oreilless
humillados	humiliés
venir	venir
bondad	gentillesse
accentoss	accentss
turismo	tourisme
abandonar	abandonner
pulgas	puces
raspón	frottement
pulgar	pouce
danés 	danois
canguro	kangourou
géiser 	geyser
café 	café
marcapasoss	stimulateur cardiaque, pacemakers
obra maestra (chef d'oeuvre)s	d'oeuvres
doloroso	pénible
adj - adhesivo; ______ tape - teor cinta adhesivas	adhésifs
las iglésiass	églisess
estimars	estimations
karates	karatés
europa oriental s	europe de l'ests
concreto	béton
sacarinas	saccharines
rosado	rose
avances	avances
maderas	boiss
baciloss	bacilless
cafés	café-restaurants
servers	serveurs
cenit	zénith
criaturas	bébés
iceberg	iceberg
satélitess	se calme, s'apaises
iridio 	iridium
adverbios	adverbes
pueblo	village
tabernáculo	tabernacle
rodio s	rhodiums
caligrafías	calligraphies
taxista	cocher de fiacre
moscú s	moscous
los hombress	hommess
montenegros	monténégros
herederos	héritiers
abolicionismo	abolitionnisme
cuidadosamente	avec attention
rajas	bombe, noces
sudáfrica 	afrique du sud
en forma aborreciente	de façon odieuse
océano atlántico 	océan atlantique
puño s	poings
excavar	creuser
(adv.) de prosa rápidamentes	rapides
carnívoro	carnivores
aúns	encores
neón s	néons
gusano	lombric
pálidos	pâles
cabalismos	cabalismes
dieciocho	dix-huit
menor	plus jeune
largos	grands
aceptor	accepteur
tés	thés
macerado	macere'
pedir	requête
las revistas	magazines
abstencioness	abstentionss
maestros	professeurs
almuerzo	le déjeuner
quietos	tranquilles
abortistass	avorteurss
accesible	accessible
musgo 	mousse végétale
cerezas	les cerises
ferrocarril s	voie ferrée ; chemin de fers
lapizs	crayons
sin brillo	terne
spainshs	directeurs
altitud	altitude
abyección	abjection
erbio s	erbiums
namibias	namibie ; république de namibies
estómagos	estomacs
cemento	ciment
bahía s	baies
paellas	paellas
cuaderno	copy book
niobio 	niobium
posios	podiums
calculars	calculers
cocodrilo 	crocodile
polígono 	polygone
bahréin, bahráin	bahreïn
acobardarse	caille
papúa nueva guinea s	papouasie-nouvelle-guinées
avenas	farine d'avoines
capitals	capitales
aerosol  -ms	aérosols
(inf.)barriga	abdomen
argón 	argon
manganeso s	manganèses
océano atlántico s	océan atlantiques
fabulista	fabuliste
lumbre s	feu ; incendies
aire	air
sartén	casserole
edulcorante s	édulcorants
agregar; (arith) sumars	summata ; additionners
escobas	balais
fruta	fruit
sacarina	saccharine
mendelevio 	mendélévium
tejóns	blaireaux
mayonesas	mayonnaises
cuidadosos	attentionnes
adios	au revoir
pastel	tarte
dagas	dagues
torta	gâteau
rejillas	étagères
abdómeness	abdomenss
conejo	lapin
pan	pain
menso	stupide
ambres	ambre ; ambre jaunes
arrancalágrimas	mélo
par	couple
cucharita	cuiller à café
koas	koalas
espinaca	épinards
tristemente	tristement
paz	paix
senegal	sénégal
radiología	radiologie
abominablemente	abominablement
avergonzados	deconcerte, confus, genes
jaulas	prisons
cuentos	histoires
pueblos	villages
vaginas	vagins
aclamacións	acclamations
globos	ballon, aérostats
(auto)sacrificarse	renouncer à
traduce	traduires
asteroide s	astéroïdes
algebras	algèbres
peligroso	dangereux
azul	bleu
clóros	chlores
bagatela	bagatelle
yodo 	iode
lacónicos	laconiques
gasolina	essence
algarabía	baragouiner
xenón s	xénons
manutención	garder
camaras	appareil photographique ; appareil photos
en extranjero (to be); al extranjero (to go)s	à l'étranger, au loins
banditos	brigands, forbans, banditss
diciembres	décembres
maldicións	merde alorss
galantementes	gallamments
kayaks	kayaks
en forma aborrecientes	de façon odieuses
aceitunas	olives
pintores	peintre
vinagre	vinaigre
presións	pressions
gaitass	comuse ; cornemuses
gaviota s	goélands
familia	famille
tizas	craies
abominación	abomination
cadmios	cadmiums
tungsteno  ; wolframio s	tungstènes
mezquitas	mosquées
holmio s	holmiums
avena	avoines
rubidio 	rubidium
b/arbaros	barbares
panadero	boulanger
toxina	toxine
atenas s	athèness
dependientes	un vendeurs
en flors	en fleurs
bellotas	glands
abreviaturas	abréviations
noviembres	novembres
indicacións	affichages
escocia 	écosse
musical	musical
león	lion
meditacións	méditations
ruegoss	prièress
wikcionario s	wiktionnaires
maquinistass	machinistess
calvicies	calvities
público	public
mula	mulet
maldición	merde alors
lago	lac
diferentes	différents
hongo s	champignons
oxígeno s	oxygènes
saboteadors	saboteurs
bohrio 	bohrium
platanos	bananess
asteriscos	astérisques
ángs	anges
ayud/o	encouragea
hierba	herbe
cocear	donner un coup de pied
entres	entres
castillos	château ; château forts
delantals	tabliers
mierdas	merdes
macropatológicos	macropathologiques
sacrificio	sacrifice
pantalón s	pantalons
helicóptero	hélicoptère
debit	débiter
faltar (something is lacking/algo falta)	simplet
caftáns	caftans
circonio s	zirconiums
dependientas	les vendeuses
palurdos	nigauds
compendios	résumés
ensalada	salade
aceptación	acceptabilité
cáñamo  ; marihuana s	chanvres
ocultos	s'enfuirs
metal s	métals
teólogos	théologiens
mas facil	le plus facile
agricultura s	agricultures
fermio s	fermiums
palabra	mot
armenia 	arménie
jades	jades
absorción	absorption
medios	médiums
acetona	acetone
arroz	riz
bacteria	bactérie
pizza 	pizza
tayikistán 	tadjikistan
pie	pied
adj & n  - adulto -ta (mf)s	adultes
gallina	poule
arana	araignée
londres s	londress
hélices	helicess
responsabilidads	responsibilités
obesos	obèses
preposición 	préposition
vocabularios	vocabulaires
verbo	verbe
contemporáneo	de la même génération
kilómetro	un kilomètre
cenicero	cendrier
academias	academies
acompanista	accompaniste
chico	garcon
donación 	don
primero	premier
tabajoso	laborieux
entrar	entrer
en suspensos	en attentes
estanques	étangs
abjasia s	abkhazies
aceptar	accepter
escandio 	scandium
belgrado	belgrade
diccionario	dictionnaire
envenenando	empoisonnement
lana	laine
camas	lits
cobalto 	cobalt
destornillador	tournevis
salivas	salives
viernes	vendredi
carnívoros	carnivores ; carnivores
laboratorios	laboratoires
lagoss	lacss
adicións	additions
capacidad de absorber	absorbabilité
salvos	les caisses
satisfechos	satisfaits
bario 	baryum
polvos	poudres
alfabeto cirílico  ; cirílico s	alphabet cyrilliques
los chinoss	chinoiss
túnez	tunisie
sueldo	salaire
juramentos	serments
rejilla	étagère
renio s	rhéniums
pelo	cheveu
órgano 	organe
atentamentes	pensivements
enfermos	malades
dañoss	dégâtss
alfabeto cirílico 	alphabet cyrillique
lapiz	crayon
abortistas	avorteurs
asteroide 	astéroïde
lapa	l'ara
faceta	facette
babuíno	babouin
adiestradores	encadreurs
prestar atencións	aviss
desears	desirer, souhaiter qchs
permitirs	autoriser, permettres
zonzo	barje
propensos	prompts
bueno	bien
abuelos	grand-père ; aïeuls
cromo	chrome
vamos	ben voyons
noventa	quatre-vingt-dix
sarténs	casseroles
tigresa	tiger
amante	amant
mas facils	plus faciles
empaquetados	paquets
permanente	constant
tierras	terres
vamoss	ben voyonss
olvido	manque de mémoire
marzos	marss
desposeido	sans-abri
arte	art
juegos	gibier ; gibiers
pipas	tuyau ; conduits
abstemio	frugal
knight	cavalier
acentuación	accentuation
canal	canal
legalizar	legaliser
oceanía 	océanie
maquinaria	machinerie
praseodimio s	praséodymes
libro de bolsillo	livre de poche
europas	europes
seguridad	le sûreté
semana	semaine
vestido	robe
zapato	chaussure
yas	dejas
actinio 	actinium
macerars	maçérers
yihad 	lutte
polvo 	poussière
canalla	cohue
caleidoscopio	kaléidoscope
mensaje	message
sabios	sage, prudent, savants
toxinas	toxines
cadencia ( musical)s	cadences
erizo 	hérisson
fogón; cocinas	cabooses
diarios	journals
castañas	châtaigniers
macromolecular	macromole'culaire
macromoleculas	macromole'cules
absorbibles	absorbables
abreviars	abrégers
lata	étain
bermudas s	bermudess
zapatos	chaussure ; pompe ; soulier ; godasse ; grolle ; tatanes
amsterdam s	amsterdams
palma  s	paumes
fin de semana	weekend
abundars	abonders
encuesta	élection
ramas	branches
facsimile	facsimilé
medallas	médailles
leche	lait
mismos	mêmes
pekín 	pékin
desvío	aberrations
teherán s	téhérans
futbol	football
tenedor	fourchette
ciudad	ville
avispas	guêpes
querhaceres (chores)	tâches
tránsito	trafic
abstención	abstention
amistad	amitie
américa s	les amériques
rutenio s	ruthéniums
entristecer	attrister
calibrados	calibrés
mujers	dames
hábitos	coutumes
sueldos	salaires
yates	yachts
sueco 	suédois
calculados	calculés
pera	poire
secreto	secret
pasar zumbandos	aller en trombes
pretéritóparticipio pasado de haves	se faire avoirs
crimen	crime
chocolates	chocolats
país	pays
pronunciación s	prononciations
junio	juin
europa occidental 	europe de l'ouest
cervezas	bières
amantes	amants
amarillosos	jaunâtres
buenas noches	bon nuit
acoladass	accoladess
macropatologías	macropathologies
erizo s	hérissons
buenos	biens
antártida	antarctique
osos	ourss
edad -f;   middle age - edad madura or mediana; old age - vejez -fs	âges
calculado	calculé
absurdos	absurdes
edad -f;   middle age - edad madura or mediana; old age - vejez -f	âge
nueva zelanda  ; nueva zelandia s	nouvelle-zélandes
medusas	meduses
bacilos	bacilles
zodiaco	zodiaque
americio s	américiums
panqueques	crêpes
pronunciación 	prononciation
castaña	châtaignier
maquinistas	machinistes
pulmón 	poumon
pacientes	douxs
sagrados	sacrés
zonzos	barjes
aleaciónes	alliages
macroprocesador	macroprocesseur
torpedo	torpille
bandidos	brigands
gadolinio 	gadolinium
terbio s	terbiums
político  ; política s	politiciens
junios	juins
costa 	côte
abjasia 	abkhazie
ochentas	quatre-vingts
cercas	proches
hábitat	habitat
pesa	poids
absternerse	abstenir
nadas	ne rien ; riens
estaci\'on dañno (noun); condimentar (verb)s	saisons
iridio s	iridiums
tecnología	technologie
asignaturas	asignaturas
marzo	mars
juezs	jugers
mar negro 	mer noire
costas dmar	littoral maritimes
ácido	acidique
laceracions	lacérations
llaves	une touches
audífonos	écouteurs
genocidio s	génocides
sagas	une sagas
temblars	tremblers
abdicable	abdiquable
acelerímetross	accéléromètress
esperar	espoir
sagaz	prudent
bailandos	dansers
vitaminas	vitamines
bromas	plaisanteries
cuentas	comptes
macroinstruccións	macroinstructions
pelos	cheveu ; poil ; chevelure ; pelages
hecho	j'adore
saltamontes 	sauterelle
agresivos	agressifs
reincidirs	régressers
producirs	rendements
estanque	étang
bermudas 	bermudes
tecnologías	technologies
libros	livres
juez	juger
desgastado(a)s	chauve, à rass
cálculos	calculs
quedar(se)	respecter
desnudo	nu
secuestro	enlèvement
feliz navidads	joyeux noël ; joyeuses fêtess
secuestra	detourner
los aross	boucles d'oreilles
desastres	catastrophe écologiques
ponderoso	pesant
ferri 	ferry
aceder	consentir
bruja	sorcière
ba ; proyectil s	balles
jornaleros	les ouvriers
lava volcanicas	magmas
ebanister/ias	ébénistess
magnesios	magnésiums
trapo (piece of cloth)s	chiffons
tres	trois
rapidamente	rapidement
climatizar	acclimater
servilletas	serviettes
bolas	bals
molestar	tourmenter
molestas	taquinss
novela	roman
dulce de chocolate	sucre a` la cre`me
ábacoss	bouliers, compteurss
página	page
sendas	sentiers
palacio	palais
inglaterra	angleterre
itrios	yttriums
desde allís	pour cette raisons
carrerass	de courses
artropodo	arthropodes
dieciochos	dix-huits
tener sexos	sexes
cardíacos	cardiaques
conejillo de indias  (especially figurative usage), cobaya / (especially scientific usage), acure  (venezuela), curí  (colombia), curi (cuba), cuy  (argentina'bolivia'chile'ecuador'peru'southern colombian andes)	cobaye
general	général
lenguaje	langue
altituds	altitudes
nadie	personne
alcachofas	artichauts
accidentalismos	accidentalismes
ganar	gagner
ajos	ails
bruma	brume
oficinas	bureaus
maltratados	insulters
submarino 	sous-marin
neptunio 	neptunium
yunque 	enclume
toros	mâle ; taureaus
municipalidads	communes
escasez	manque
huérfano	orphelin
hábito	coutume
hornears	faire cuires
macroeconomias	macro-économies
cableados	cablages
alb"ó"ndigas	boulette de viande
abreviaturass	abréviationss
vierness	vendredis
abreviados	abrégés
ingléss	anglaiss
bruselas s	bruxelless
olvidados	oubliés
abreviador	abréviateur
costar	coût
a bordo des	à bords
barro	vase
cementos	ciments
ablativo	ablatif
átomo s	atomes
encubres	secourirss
buenas noches 	bonsoir
olvidado	oublié
ladrón	voleur
mariquitas	coccinelles
abortivamente	en vain
calendarios	calendriers
veranos	étés
faltar (something is lacking/algo falta)s	simplets
yos	j' ; jes
genocidio 	génocide
caballeros	des chevaliers
responsabilidad	responsibilité
llover	flotte
producir	rendement
cabotajes	cabotages
abad	abbé
jocos	juss
locomotoras	locomotives
caftán	caftan
acantilado	falaise
tabú	tabou
hafnios	hafniums
océano pacífico s	océan pacifiques
paquidermo	pachydèrme
oculto	s'enfuir
bostezo	bâiller
submarino s	sous-marins
traductor	traducteur
ingenuamentes	naivements
crema	crème
ceniza s	cendres
comer	manger
papagayo  ; loro  ; cotorra s	perroquets
sablears	mendiers
jovens	jeunes
islas baleares s	îles baléares ; iles baléares ; baléaress
delfín s	dauphins
hoja	feuille
cobres	cuivres
papis	papas
calvicie	calvitie
penínsu	péninsule
hoy	au'jour d'hui
libertad s	libertés
onces	onzes
obeliscos	obélisques
cucharillas	cuiller à cafés
silicio s	siliciums
sinagogas	synagogues
sagacidad	la sagacité
índice s	indexs
cerezass	les cerisess
disputass	luttess
dolor de oreja	mal d'oreille
accesorios	accessoires
día	jour
avestruz 	autruche
diecinueves	dix-neufs
envidiar	envidiar
macarróns	macarons
fiel	fidèle
discurso	discours
domingo	dimanche
neptunio s	neptuniums
abandonandos	abandonnants
insectos	insectes
hola	bonjour
astato 	astate
acentuacións	accentuations
pollos	poulets
abiótico	abiotique
celular ( anglicism)	cellulaire
(of the alphabet) letras	caractère ; lettres
juventud	jeunesse
levaduras	levures
cachalotes	cachalots
islas feroe s	îles féroés
pulpo s	poulpe ; pieuvres
cacto	cactus
brumas	brumes
abadías	abbayes
concretos	bétons
ponderas	pèses
sermón	sermons
creer	croire
absolución	absolution
interéss	intérêtss
bucarest	bucarest
mercurio s	mercures
conciliábulo	cabale
ponderar	peser
lechuga	salade
antecedentess	arriere-planss
accesorioss	accessoiress
pacificacioness	pacificateur / -trice s
altura	hauteur
apartamentos	apartement, chambres
puntillismos	pointillismes
hiena s	hyènes
talio 	thallium
mulas	mulets
educación s	éducations
molibdeno s	molybdènes
trabajos	emplois
sols	soleils
primo	cousin
tigre	tigre
anormalidad	anomalie
túnezs	tunisies
por accidente	accidentellement
sacramentoss	sacrementss
nueve	neuf
lagos	lacs
lágrima	larme
yardas	yards
adquisiciones	acquisitions
suiza 	suisse
juego	gibier
econom'ia	économie
acústica	acoustique
puercos	cochons
los muchachoss	garçonss
triste	triste
uranos	uranuss
enseñando	enseignement
lavars	lavers
abstenerse de	renoncer
codos	coudes
alfombras	tapiss
macropatología	macropathologie
correos 	poste
siete	sept
planta 	plante
abortantes	avorteur/ avorteuse / faiseuse d'angess
jornalero	l'ouvrier
las afueras	banlieues
manejars	conduires
mañana	demain
lapas	l'aras
litera	cabane
antecedentes	arriere-plans
acompañars	accompagners
abundando	abondant
sin domicilio fijo	of no fixed ~ :sans domicile fixe
disparates (plural)s	absurditéss
lindar	etre contigus
hongos	champignons
aceptable	convenablement
papass	papass
laceracion	lacération
inglaterras	angleterres
lentos	lent ; lentes
tienda	boutique
salados	salés
aplaudir	acclamer
equivocacións	aberrations
sin gustos	insipides
enfermo	malade
gaviota 	goéland
anión	anion
ballena s	baleines
los meses	moiss
pacifismos	pacifismes
hora	heure
alpes s	alpess
producto	produit
iterbio 	ytterbium
georgia 	géorgie
atentos	attentifs
resumens	résumé, abrégés
puro (mex)	cigare
plantas	plantes
hongo 	champignon
pelotas	cautions
edificios	bâtiments
crucigrama 	mots croisés
atentamente	pensivement
todos los diass	quotidiens
servilleta	serviette
valioso	précieux
alojados	accommodés
radar	radar
nuezs	la noixs
titanio s	titanes
teddy	sortir
asterisco	astérisque
edificio	bâtiment
tabletillass	compriméss
académico[conjunction]	académique
embarazo 	grossesse
copo de nieve  ; ampo s	flocon de neiges
reajusta	réajuste
radio	radio
luness	lundis
balbuceador	bavardent
teología	théologie
hogar	maison
aborrecido	avoué
abolicionistas	abolitionnistes
cables	câbles
estrella	étoile
cbalístico(a)	cabalistique
yugoslavia  ; yugoeslavia s	yougoslavies
cabriolet	cabriolet
problema	problème
comején	termites
desdeñoso	méprisant
piloto	pilote
arenas	sables
musgo s	mousse végétales
vecinas	voisins
cueva	grotte
mozambiques	mozambiques
enojados	fou, folles
copo de nieve 	flocon de neige
dentado	e'bre'che
malasia 	malaisie
libélu	libellule
aclimatados	acclimatés
renunciar a; abdicars	renoncers
mesa	table
realidad	fait
sacerdotals	appartient a une chose religieuses
enero	janvier
voleibol s	volley-balls
cactuss	cactuss
agostos	aoûts
bandas	bande, chapelles
cuidadoso	attentionne
valle 	vallée
fins	fins
darse cuenta de	réaliser
ocho	huit
cordero	veau
hielo	glace
las obras	travails
negro	noir
litio s	lithiums
turismos	tourismes
acompanados	accompagnés
ablativos	ablatifs
periné  ; perineo s	périnées
patinars	patins
conocido	connu
blanco	blanc
dentistas	dentistes
elefante	éléphant
buenas nochess	bon nuits
octubre	octobre
acentuado	accentué
mayonesa	mayonnaise
programa	logiciel
vinagres	vinaigres
computadora	ordinateur
barbillas	feuillures
morir	mourir
acuerdos	contrats
los abogados	avocats
deprimente	faiblant
polémicamentes	de manière polémiques
macroestructuras	macrostructures
elefantes	éléphants
avión	appareil volant
filipinas 	philippines
taxi	taxi
topografías	topographies
galantería	la gallantrie
capítulo	chapitre
apreciars	reconnaissants
mazas	masse
armenio  ; armenia s	arméniens
vampiros	vampires
vivirs	vivres
galantemente	gallamment
adquisición	acquisition
sombra 	ombre
pelota	ballon
escuela	école
bárbaro	barbare
mar mediterráneo s	mer méditerranées
anualmente	annuellement
estufa	étuve
sudán 	sudan
hoys	au'jour d'huis
arista eminent en cualquiere de las bellas artess	maestros
punteros	pointeurs
cacofonías	cacophonies
cromos	chromes
cadetes	cadet, younger sons
temperatura	température
macerar	maçérer
cédula	cellule
pesquero(a)s	pêches
electrón 	électron
diestro; habilidos; astuto; artificiosos	rusés
galerías	galleries
sábados	un sabbats
aluminio s	aluminiums
aclimatado	acclimaté
californios	californiums
seiss	sixs
próstatas	prostates
mongolia s	mongolies
comos	aimers
habilitacións	habilitations
fuente	fontaine
inviernos	hivers
aspirina	aspirine
lingüística s	linguistiques
francias	frances
acumulador/ras	accumulateurs
ucrania 	ukraine
venezue	venezuela
escarchas	gel ; givres
océano índico s	océan indiens
supresión	suppression
tradicionals	traditionnels
navajas	couteaus
dedo dpie	orteil
pulgars	pouces
francio s	franciums
uvas	raisins
arrendajo , urraca s	geais
alemán	allemand
la haya 	la haye
cristal	cristal
aunques	quoique, bien ques
bario s	baryums
conforme	conformité
bosque	forêt
macabros	macabres
sábado 	samedi
sorpresa	étonner
comida	repas
lagartos	lézards
abrils	avrils
suicidio 	suicide
frio	froid
cañón 	gorge
sietes	septs
galaxiass	galaxiess
pinturas	peintures
baladass	balladess
puertas	portes
teorema	théorème
totalmente (totally); ¡por supuesto (que sí)! (certainly!)s	absoluments
gatito	chaton
absorbible	absorbable
voleibol 	volley-ball
(adv.) de prosa rápidamente	rapide
oceanía s	océanies
fotografía 	photographie
astronomía 	astronomie
gibraltar 	gibraltar
brasil s	brésils
abdómenes	abdomens
cráneo 	crâne
oasiss	oasiss
potencia 	puissance
abreviatura	abréviation
traer	apporter
violars	colzas
las brujas	sorcières
objeciones	objections
morirs	mourirs
abyectamente	avec servilité
pálido	pâle
armenio 	arménien
transacción	transaction
legumbre	légume
junípero 	genièvre
géiser s	geysers
maltratado	insulter
zonas	zones
placentas	placentas
neblina	brouillard
kilos	kilos
anhelo	désir
téniss	tenniss
bibliotecas	bibliothèques
meditación	recueillement
fotografía s	photographies
guardado (that's just 1 meaning)s	bourré des
mamíferos	mammifères
calidads	qualités
gorgojo	charançon
abundante	abondant
temprano	tôt
raspóns	écorchures
coless	chouxs
abecedarios	abécédaires
mozambique	mozambique
sadista	sadiste
papas	papas
nombres	prenoms
derechos humanos 	droits de l'homme
dormir	dodo
eslovaquia s	slovaquies
trayectorias	trajectoires
probars	prouvers
niembre de mafias	mafieuxs
(automobile) choque	accident
cafeteríass	cafétariass
libertad 	liberté
paladio 	palladium
azúcar 	sucre
académicos	académiciens
cultura	culture
teólogo	théologien
graciosos	plaisants
neerlandés ; holandéss	néerlandais ; hollandais ; flamand ; flamands
venirs	venirs
tiempo	temps
balcons	balcons
predicas	prononces
electricidad	électricité
gemelo	jumeau
cómplices	complices
en sentido de las agujas drelojs	dans le sens des aigüilles d'une montres
valiosos	précieuxs
acero	acier
aguilas	aigles
abrasible	qui peut s'érafler
mamífero 	mammifère
sadismo	sadisme
alcohols	alcools
n - (to the hospital) adnision -f (accent over the   o); ingresos	aveus
calor	chaleur
apaciguars	pacifiers
tecla	clavier
cortés	poli
emiratos árabes unidos 	émirats arabes unis
separandos	enlevants
piscina 	piscine
cien	cent
ayers	hiers
zigzags	zigzaguers
entregars	accouchers
myanmar 	birmanie
reno  ; rangífero s	rennes
donación  ; donativo s	don ; donations
teoremass	théorèmess
república dominicana	république dominicaine
polonio s	poloniums
venenosos	poisons
mirlo s	merles
pájaros	oiseaus
sureste asiático s	asie du sud-ests
cuento	histoire
einstenio 	einsteinium
palma  	paume
verdadero	vrai
abreviando	abrégeant
corderos	veaux
alianza	convention
electrónicas	électroniques
aclimars	acclimaters
roma 	rome
cuenta	compte
cadas	chaques
abdominalmente	abdominalement
aceptors	accepteurs
papel	papier
agosto	août
arrodillarse	s'agenouiller
ambre	ambre
perdón	pardon
abejorro  ; abejarrón s	bourdons
arcoiris	arc-en-ciel
castor 	castor
delfín 	dauphin
predicador	prédicateur
francio 	francium
flecha	flèche
planos	plaines
singapur s	singapours
alojamientos	accommodations
fumar	fumée
leóns	lions
caballeross	des chevalierss
amarillandos	jaunissants
desnudos	nus
traidor	traître
hígados	foie
pronto	rapide
aguas	eaus
cabriolets	cabriolets
legumbres	légumes
accedidos	accessés
enseñandos	enseignements
magnetismo	magnétisme
papagayo 	perroquet
navaja	couteau
absueltos	exonérés
ucrania s	ukraines
aleación	alliage
ingenuo	naif
excavar ; ahondar ; cavars	creusers
república centroafricana	république centrafricaine
maquinación	machination
serpiente 	serpent
arcoiriss	arc-en-ciels
persona	personne
tocars	tapoters
ponderars	pèse
arsénico s	arsenics
liquidacions	les ventes
coraje 	courage
cerebro	cerveaux
éls	ils
chimenea	cheminée
acompaña	accompanies
protactinio 	protactinium
traidors	traîtres
nieto	petit-enfant
culturas	cultures
piscina  ; alberca  ; pileta de natación  s	piscines
hacia atráss	déconcertés
alfil 	évêque
páncreas s	pancréass
tejido	tissu
gorgojos	charançons
abdominals	abdominals
herida	blessure
empaquetar	emballage
los laboratorios	labos
puntero	pointeur
abscesoss	abcèss
odios	aversion extreme, horreurs
cardíaco	cardiaque
lumbre 	feu
caballas	maquereaus
invierno	hiver
juntoss	ensembles
pasos	vitesses
corazón s	cœurs
accidentalmente	accidentalement
irs	allers
tocinos	bacons
coliflores	chou-fleurs
cumplido	accomplir
computadorass	ordinateurss
matemáticas s	mathématiquess
finlandés 	finnois
desayuno	petit-déjeuner
accidentess	accidentss
algoritmo	algorithme
noveno , novena , (abbreviations) 9º , 9ª s	neuvièmes
abdominalmentes	abdominalements
amarillós	jaunis
gabinete	cabinet
caballa	maquereau
de fondo	arriere-plan
pelícu ; filme s	film ; pellicules
democracia	démocratie
pilotos	pilotes
cinta	dentelle
boro s	bores
primeros	premier ; premières
econom'ias	économies
caballo	cheval
arista eminent en cualquiere de las bellas artes	maestro
las ananás	ananas
burlonmentes	pour taquiners
vacío	vide
galopando	gallopant
dedos	doigt ; doigts
músicas	musiques
nina	fille
espaldas	en arriere, en retours
planetas	planètes
estufas	étuves
ambientes	environnements
lípidos	lipides
rey	roi
fresas	fraises
esqueleto 	squelette
englishs	alphabetiques
canguros	kangourous
cirujanos	chirurgiens
cinc	zinc
amsterdam 	amsterdam
polémicamente	de manière polémique
lacayo (sirviente)	laquais
ganso 	oie
helicópteros	hélicoptères
tifón	typhon
osmio s	osmiums
rostro	face
acentos	accents
sojuzgar	joug
abstinentamentes	sobrements
teorizars	théorisers
ascensors	ascenseurs
antilopes	antilopes
gibraltar s	gibraltars
miles	milles
ahora	maintenant
vecina	voisin
tabúess	tabouss
envenenandos	empoisonnements
cielos	ciels
agricultura 	agriculture
tambien[conjunction]s	aussis
señorita	mademoiselle
las comidas	repas
fachada	façade
infiernos	enfers
cucharas	cuillers
apartamento	apartement
mar negro s	mer noires
martess	mardis
represas	barrages
algarabías	baragouiners
desde entoncess	dès lorss
instigación	encouragement
parís s	pariss
antigua y barbuda	antigua-et-barbuda
ulcera	ulcère
pesados	lourds
abolido	aboli
ausentes	absentees
bambú	bambou
tímpano	tympans
mover	remuer
tuvo lugar	tenu
serbia 	serbie
derechos humanos s	droits de l'hommes
acá	ici
apaciguar	pacifier
navidad	noël
memoria	mémoire
corazón 	cœur
absolutismos	absolutismes
nevars	neiges
alabar	grêle
américa dnorte 	amérique du nord
habilitado	habilité
noventas	quatre-vingt-dixs
febreros	févriers
tornados	tornades
abeja	abeille
ábacos	abaque ; bouliers
anormalmentes	anormalements
champañas	champagnes
abolirs	en train de bouillirs
dialecto s	dialectes
delicado	plus délicat
abstracciones	distraction, abstractions
recetas	recettes
promecio 	prométhium
hidrógeno 	hydrogène
rabioso	enragé
sagazmentes	prudemments
múnich s	munichs
nada	ne rien
londres 	londres
daños	dommages
saboteado	saboté
ablación	ablation
periné 	périnée
conejoss	lapinss
pantalón  ; pantalones s	pantalons
las leyendas	legendes
tulio 	thulium
flúor 	fluor
meditars	médite
alojando	obligeant
radón 	radon
polar	polaire
cachalote	cachalot
debits	débiters
renunciar a; abdicar	renoncer
ajo	ail
labio	lèvre
yoga 	yoga
historias	histoires
encubre	secourirs
lento	lent
cada	chaque
de frente: "to keep abreast of" (fig): mantenerse al corriente de	de front
panaderias	boulangeries
televisión	télévision
pensamiento s	reflexion; intention, desseins
vanadio s	vanadiums
chistosos	amusants
caviár	caviar
conferensista	conférencier
movers	remuers
brazos	brass
acelera	accélérers
absurdismos	absurdismes
sangres	sangs
odio	aversion extreme
pacíficamentes	pacifiquements
aclimar	acclimater
aceptado	accepté
abracadabras	abracadabras
suiza s	suisses
ala	l'aile
infierno	enfer
absorber	absorber
celosos	zélés
odia	abhorrer
absolucións	absolutions
bordes	rebords
españa s	espagnes
los aros	boucles d'oreille
reirse	rire
separado de línea media dcuerpo.	enlevé
tendenciass	tendancess
madre	mère
pregunta	question
alas	l'ailes
marineros	les marins
unis	chauxs
río 	fleuve
calibraciones	étalonnages
polaridads	polaritys
piyamass	pyjamas
predica	prononce
jardín zoológico	zoo
spainsh	directeur
yema de huevo	jaune d'oeuf
maquinarias	machinerie
polarizado	polarisé
jabón 	savon
seguestar	kidnapper
anc	ancre
zoologías	zoologies
jardinero	jardinier
policíass	contractuelless
ausentess	absenteess
contar	compter
ablucioness	ablutionss
minuto	minute
gramatica	grammaire
mantequilla	beurre
niobio s	niobiums
estaci\'on dañno (noun); condimentar (verb)	saison
condenado	damné
acné	acné
facilitars	facilite
mezcolanzas	mélanges
desamparados	délaissés
selva	jungle
unos	uns
teocracias	théocraties
seguridads	le sûretés
portugal 	portugal
café	café-restaurant
caballos	chevals
irlanda dnortes	irlande du nords
ciervo  ; venado s	cerfs
pinchazo	planter
english	alphabetique
obesidad	obésité
calors	chaleurs
topografía	topographie
cédulas	cellules
fabulosos	fabuleuxs
tristes	tristes
verdad	vérité
sordo	sourd
dulce	doux
décimos	dixs
grita	hurlers
llegars	arrivants
odias	abhorrers
absolutos	absolus
meditaciones	méditations
encima	au-dessus
jirafa	girafe
grito	hurler
manejar	conduire
perdóns	pardons
en flor	en fleur
moldavia 	moldavie
limón	citron
hábil (skilled)	capable
maquinista	machiniste
condenados	damnés
vt - ajustar	ajuster
algebra	algèbre
hábilmente	de façon compétente
iterbio s	ytterbiums
sueco s	suédoiss
aguiluchó l'aiglon (aguilucho)s	aiglons
de estados	d'états
comercios	commerces
camara	appareil photographique
áng	ange
maquinacións	machinations
tarjeta	carte
cama	lit
productos	produits
electromagnetismo 	électromagnétisme
aro	boucle d'oreille
pastor  ; ovejero s	berger ; pasteurs
públicos	publics
sacrificios	sacrifices
autorizado	accredité
broma	plaisanterie
artículos	articles
cortéss	polis
abstruso	abstrus
acústicas	acoustiques
puntillistico	pointilliste
habitación	demeure
raíz  ; raícess	racines
abyectamentes	avec servilités
sociedads	sociétés
racismos	racismes
ladrillo	brique
cometas	cerf-volants
cacofonía	cacophonie
clorúro	chlorure
cáncer	cancer
xilófonoss	xylophones
sedas	soies
arco s	arcs
orgasmo 	orgasme
predicadoress	prédicateurss
gatitos	chatons
abscesos	abcèss
cabarets	cabarets
primos	cousins
acantos	acanthes
carbohídratos	hydrate de carbone ; glucides
aceptables	convenablements
asistente	gardien
aeropuerto	aéroport
asignatura	asignatura
abusivamente	abusivement
acá ; hacia acás	icis
negocio	entreprise
espada 	épée
chinear	choyer
selenio s	séléniums
lacónico	laconique
abominacioness	abominationss
feliz navidad	joyeux noël
mezcolanzass	mélangess
arma 	arme
xilófonos	xylophones
júpiter s	jupiters
fabuloso	fabuleux
alpes 	alpes
acentuar	accentuers
facilidad	usine
teórico	théorique
santoss	saintss
acompañamientoss	accompagnementss
cortado	abbrégé
alma	âme
presión	pression
morsa 	morse
sendero	sentier pedestre
peligros	dangers
ingenuos	naif, naives
saluds	santés
jardín	jardin
parabrisa (se usa en los eeuu)	le parebrise
polémico	polémique
vidrios	verres
acuariums	aquariums
accesoress	accesseurss
yodo s	iodes
oceanografias	océanographies
húngaro  ; húngara s	hongroiss
de artes	d'arts
espalda	derrière
obediente	soumis
casa	maison
racials	racials
consumos	consommations
reduccioness	s'abrèges
papels	papiers
triángulos	triangles
mantel	nappe
malos	mauvais, torves
piano	piano
axi	aisselle
burros	ânes
internet  ; red s	internets
plazas	carrés
casi	presque
acumulados	accumulés
cortars	économies
remo	rame
pared (a dentro)	mur
navidads	noëls
amenazadamente	d'un ton menacant
judaísmo 	judaïsme
otoños	automnes
hormiga	fourmi
habitante	habitant
laberintos	labyrinthes
abrrogado	abrogé
aceptars	accepters
aligátor  ; aligator  ; caimán s	alligators
teoriass	théoriess
asistir	s'occuper de
cielo 	paradis
calibración	étalonnage
libros de bolsillos	livres de poches
yate	yacht
clarinete 	clarinette
océano ártico s	océan arctiques
lobos	loups
oveja	mouton
aguila	aigle
canallas	cohues
abominables	abominables
tácito	tacite
vils	méprisables
cartero(a)	facteur
electrónica	électronique
piernas	jambes
kilo	kilo
gentes	genss
escandio s	scandiums
violar	colza
viena s	viennes
diccionarios	dictionnaire ; dicos
magoss	magicienss
correos  ; casa de correos  ; oficina de correos s	postes
kayak	kayak
cañón  ; barranca s	gorges
galopandos	gallopants
abdicador	abdicateur
territorios	territoires
abiyán	abidjan
mora	tolère
libro de lectura	lecteur
sonido  ; son s	sons
darse cuenta des	réalisers
temperaturas	températures
corchos	lièges
jueves	jeudi
ulceras	ulcères
acidificación	acidification
riñón s	reins
anuario	annuaire
mariposa s	papillons
llave	une touche
lloroso	tout en pleurs
serbia s	serbies
judaísmo s	judaïsmes
ensaladas	salades
sermonears	prononcers
amarilloso	jaunâtre
grajilla	choucas
hunters	chasseurs
bostezandos	bâillements
polarizars	polarisers
vino	vin
cuevas	grottes
cebos	leurre, eches
taladradora	marteau piqueur
tronada	orage
cadáver	cadavre
nave	bateau
acordeonistass	accordionists     accordionistess
acetificar	acetifié
tomates	tomates
virus 	virus
alquitranado	macadamisé
gustos	goûts
abecedario	abécédaire
venenoso	poison
difícil	difficile
dios s	dieus
galaxias	galaxies
suerte	chance
trompeta s	trompettes
venenoss	poisonss
trueno	tonnerre
noviembre	novembre
folletos	brochures
señora	mademoiselle
lógicas	logiques
amenaza	menacers
supresións	suppressions
estrés	stress
comercio	commerce
difamar	calumnier
ninas	filles
chimpanc/e	chimpanzé
llegar	arrivant
abundar	abonder
tener sexo	sexe
prontos	rapides
mutación	mutation
anormals	anormals
rascacielos 	gratte-ciel
cebra	zèbre
asistentes	gardiens
fabula	fable
moró	souffri
exámen	test
bancos	berges
cerio 	cérium
sal	sel
san	saint
coartadas	alibis
talio s	thalliums
n  - adopciones -f (accent over second  o)	adoptions
ruido	bruit
patinar	patin
cascos	casques
macrocosmos	macrocosmes
acompanado	accompagné
a popa	en l'arrière
abjurar	personne qui abjure
desastre	catastrophe écologique
teclas	claviers
orquesta	orchestre
de ser	d'être
mismo	même
periódico s	journals
yelmos	barres
instigar	encourager
abundancias	abondances
pescado	poisson
polaridades	polarités
tecnecio 	technétium
pájaro	oiseau
huérfanos	orphelins
galería	gallerie
lyón	lyons
rasgas	larmess
neptuno s	neptunes
abjurars	personne qui abjures
perdonar	pardonner
abejas	abeilles
posio	podium
pedirs	requêtes
ablucións	ablutions
aclamación	acclamation
ruidos	bruits
globo	ballon
puntillistas	pointillistes
bacarr/as	baccarats
pasados	passés
personas	personnes
perdonas	pardonnes
celoso	jaloux
conserjes	concierges
kiosko	kiosque
garza s	hérons
plans	plans
travesaños	registres
oso polar 	ours blanc
plano	plaine
aacidentalistas	accidentalistes
fachadas	façades
turkmenistán s	turkménistans
joco	jus
rodio 	rhodium
chaquetas	vestes
pulga	puce
gracias	remerciement
ciego	aveugle
gadolinio s	gadoliniums
en ausencia	distraitement
desempleo 	chômage
barbero	barbier
horas	heures
mutacións	mutations
teoremas	théorèmes
calabacíns	courgettes
sed	soif
abuso	abus
aguilass	aigless
jirafas	girafes
bismuto s	bismuths
mozo	garçon
nepal 	népal
medicina	médecine
macroevolucions	macroe'volutions
futbols	footballs
novelas	romans
humillado	humilié
xenón 	xénon
república dominicanas	république dominicaines
cábalas	cabales
academicas	académiques
dañado	endommagé
cigarro (mex)	cigarette
granada 	grenade
vaca	vache
sagrado	sacré
asasino	un tueur
caligrafía	calligraphie
disparates (plural)	absurdités
aceptacións	acceptabilités
resumen	résumé
rogars	priers
exhibirs	pièce d'expositions
habilitación	habilitation
cielo  ; firmamento s	paradiss
tuvo lugars	tenus
vivo	facile
envidiars	envidiars
bolsillo	poche
él	il
tímpanos	tympanss
petróleo s	pétrole ; or noirs
absenta	absinthe
suecia s	suèdes
mantequillas	beurres
reys	rois
traductors	traducteurs
macho	macho
sin gusto	insipide
almuerzos	le déjeuners
cursos	courss
mercurio 	mercure
ausenciass	absencess
ajedrez	échecs
sacarosas	saccharoses
pascua s	pâquess
macerados	macere's
alegría 	joie
macroeconomia	macro-économie
acomodars	accomoders
mariposa 	papillon
luna	lune
pegars	frappers
xilófono	xylophone
b/arbaross	barbaress
sin	sans
sis	ouais!s
damass	mesdamess
literaturas	littératures
represa	barrage
historia	histoire
dedo	doigt
mundo	monde
s. piedras trituradas para macadamisar; calzada empedrada con ellas.	macadam
gramaticas	grammaires
computadoras	ordinateurs
pagado	payé
fresa	fraise
cerdos hormigueross	tamanoirss
flauta s	flûtes
rogar	prier
mesass	tabless
internet 	internet
dolorosamente	douloureusement
cerca	près
abolicíon	suppression
yunque  ; bigornia s	enclumes
pensamiento 	reflexion; intention, dessein
antimonio 	antimoine
decir	dire
conejillo de indias  (especially figurative usage), cobaya / (especially scientific usage), acure  (venezuela), curí  (colombia), curi (cuba), cuy  (argentina'bolivia'chile'ecuador'peru'southern colombian andes)s	cobaye ; cochon d'indes
animals	animals
concurso	contester
tigres	tigres
antimonio s	antimoines
escasezs	manques
pagano	païen
tigresas	tigers
muerto	mort
jovencitos	jeunes
doctrina	doctrine
tántalo s	tantales
viento	vent
contars	compters
fardos	ballots
turquía 	turquie
plata	argent
instigadors	aide, complices
contador	comptable
saltars	printempss
recomendado	recommandation
largo	grand
apatico	nonchalant
máquina[]s	machines
atrasados	en arrières
las lluvias	flotte ; pluies
academismos	academismes
macropatológico	macropathologique
refrescos	boissons
bohrio s	bohriums
paella	paella
molestars	taquins
ecuación 	équation
combustible	combustible
polonia 	pologne
taladradoras	marteau piqueurs
selvas	jungles
teóricos	théoriques
abulón	ormeau
pacificador	tétine
renio 	rhénium
transmite	transmettres
cebada 	orge
magistralmente	magistralement
aerosol  -m	aérosol
sordos	sourds
cabinass	cabiness
madera	bois
abortoss	avortementss
trabajo	emploi
nueva zelanda 	nouvelle-zélande
vinos	vins
plaza	carré
sol	soleil
piedra	pierre
kilate	carat
lagunas	lagunes
hassio 	hassium
samario 	samarium
vano	vain;
helio	hélium
tocino	bacon
berkelio 	berkélium
terrorismos	terrorismes
pacíficamente	pacifiquement
dios 	dieu
avergonzar s	confondre, déconcerters
diestro; habilidos; astuto; artificioso	rusé
potencia  ; poder s	puissances
estacións	gare ; stations
chistoso	amusant
accesibles	accessibles
manchars	macule
obediencias	obéissances
cataratas	cascades
proyecta	envisage
dedo dpies	orteils
suprimibles	qui peut être abolis
dependientess	les vendeurss
bolso	sac
mantels	nappes
bismuto 	bismuth
bactericidas	bactéricides
refresco	boire
tronadas	orages
sacrificado	sacrifier
dormidos	endormis
camellos	chameaus
anormal	anormal
racial	racial
ténis	tennis
what happened? i just wanted to erase "almacén"![conjunction]	magazine
academicamentes	académiquements
capacidad de absorbers	absorbabilités
abstenciones	abstentions
acompañamiento	accompagnement
abundantemente	abondamment
abortos	avorte
marinero	marin
facial	facial
brusco (manner)	abrasif
puente	pont
estómago	estomac
acompañamientos	accompagnements
abdicado (participio de abdicar)	abdiqué
kosovo 	kosovo
notificación	notification
bolass	balss
franja de gaza 	bande de gaza
tocar	tapoter
a popas	en l'arrière, vers l'arrières
clorúros	chlorures
playa	plage
carreras	de course
itrio	yttrium
traducción	traduction
escarabajo s	coléoptères
cartografías	cartographies
kosovo s	kosovos
jaula	cage
exhibir	pièce d'exposition
humillars	mortifie
serbia y montenegro	serbie-et-monténégro
mapache	raton-laveurs
oportunidads	hasards
alcohol	alcool
deuda	dette
jicoteas	tortue terrestres
guerras	guerres
cobardes	lâches
mansedumbre	soumission
académico	académique
gerencia	gestion
física 	physique
georgia s	géorgies
alianzas	conventions
juramento	serment
realismo	réalisme
zigzag	zigzaguer
joven	jeune
notificacións	notifications
audífonoss	écouteurss
arbóls	arbres
entristecers	attristers
doctors	docteurs
yegua s	juments
muñecas	poupées
vivir	vivre
ciencias	sciences
ganars	gagners
biblia s	bibles
acceso	accession
jarras	secousses
tabletilla	comprimé
fourty	quatre
guardado (that's just 1 meaning)	bourré de
fabulas	fables
estadística	statistiques
eslovenia 	slovénie
douments	têtes
badmintons	badmintons
lechugas	salade ; laitues
cactus	cactus
hojas	feuilles
aborigen	aborigene m/f
decisión	décision
abortandos	discontinuants
knights	cavaliers
comunismo 	communisme
absorbentes	absorbants
sábado s	samedis
empaquetando	emballage
tornillos	vis ; vis de fixations
seguestars	kidnappers
arquitectura 	architecture
facsimiles	facsimilés
actinio s	actiniums
mierda	merde
raíz 	racine
parabrisa (se usa en los eeuu)s	le parebrises
hilo	fil
problemas	problème ; hics
manchado	macule'
lantano 	llanthane
abominablementes	abominablement, odieusements
fugas	fugues
ajedrezs	échecs ; jeu d'échecs
torpedos	torpilles
quilla	la quille
dalmata	dalmatien
contabilidades	comptabilités
los pinos	pins
tren ( noun) adiestrar ( military)s	trains
cinco	cinq
toser	tousser
sobrenivel	au-dessus du sol
abrrogados	abrogé, abolis
pezoness	tétonss
libélu ; aguacil  ; pipilacha  s	libellules
distraídos	distraits
racista	raciste
lógica	logique
cincs	zincs
abyeccións	abjections
maquinados	machinés
reino	royaume
raers	user en frottant, éroders
incineraciones	incinérations
facilitar	faciliter
agresivo	agressif
cebolla	oignon
sins	sanss
luzs	lumières
queso	fromage
telévisiones	télévisions
once	onze
transcribirs	transcrires
cantidad	quantité
reina	reine
uranio 	uranium
permanentes	constant, éternels
destornilladors	tourneviss
acentuados	accentués
noveno , novena , (abbreviations) 9º , 9ª 	neuvième
jaulass	cagess
exámenes	test ; testers
oficina	bureau
río s	fleuve ; rivières
república centroafricanas	république centrafricaines
cuidado	care
machetes	machettes
ranas	grenouilles
robles	chênes
vanos	vain;s
vacunas	vaccinations
cobarde	lâche
solteros	célébataires
áfrica s	afriques
arco 	arc
aires	airs
bolsos	fouilles
puro (mex)s	cigare ; סיגרs
galanterías	la gallantries
daño	dommage
suprimible	qui peut être aboli
pescados	poissons
pescador	pêcheur
bailariness	danceurss
tornillo	vis
soltero	célibataire
verdads	vérités
hada	fée
sodio s	sodiums
ingenuamente	naivement
sauce s	saules
saco	virer
acelerímetro	accéléromètre
académico[conjunction]s	académiques
saturnos	saturnes
bostezando	bâillement
escaparses	s'enfuirs
cromatografía	chromatographie
arado s	charrues
cielo	ciel
juvenils	juvéniles
geografía 	géographie
batracio ( animal)	crapaud
naves	bateaus
climas	climats
besars	embrassers
cablegrama	câblogramme
secuestradoress	adducteurs
intérprete s	interprètes
singapur 	singapour
producto lácteos	laitiers
palabras	mots
septiembre	septembre
joya	joyau
gaitas	comuse
fósforo 	phosphore
distraidamente	distraitement
instigandos	provoquants
paquidermos	pachydèrmes
acompañantess	accompagnateurss
acantoss	acanthess
difícils	difficile ; dur ; compliqué ; épineux ; ardu ; délicat ; malaisés
playas	plages
acetaminofén	acétaminophèn
gusanos	lombrics
parto (childbirth)	travail
generals	générals
legalizars	legalisers
disputa	lutte
mundos	mondes
descuento	la suppression
indicación	d'affichage
legítimos	régulier, corrects
conciliábulos	cabales
s. piedras trituradas para macadamisar; calzada empedrada con ellas.s	macadams
lisboa s	lisbonnes
secos	sec ; sèches
ácidos	acidiques
búlgaro 	bulgare
arcil	argile
cabless	câbless
koa	koala
estimar	estimation
taxiss	taxiss
argumentos	disputes
padres	papas
teorizar	théoriser
señoras	mademoiselles
democracias	démocraties
soñar	rêver
montaña 	montagne
cocodrilo s	crocodiles
yema de huevos	jaune d'oeufs
net(red)	r
cerio s	cériums
ceros	zéros
neodimio s	néodymes
hornear	faire cuire
ausencia	absence
balancears	bilans
abordar	accoster
ganso  ; oca  ; ánsar  s	oies
panqueque	crêpe
saga	une saga
camion	camion
continente	continent
pacifico	pacifique
llenos	plein ; bondé ; bondés
pescadors	pêcheurs
ratóns	souriss
señoritas	mesdemoiselles
tabaco	tabac
pared (a dentro)s	murs
geometrías	géométries
premio máximo	gros lot
malogrados	ratés
sablear	mendier
yogur 	yaourt
rubidio s	rubidiums
polonio 	polonium
matar	tuer
acumulador/ra	accumulateur
instigacións	encouragements
lámpara	lampe
desgastado(a)	chauve
mensos	stupides
camino	route
kétchup  ; ketchup s	ketchups
laguna	lagune
tristeza	tristesse
paquetes	paquet;ballots
carcinógenos	cancérigènes
manzanas	pommes
escarcha	gel
sacramentos	sacrements
nacional	nationalé
maceración	mace'ration
islas baleares 	îles baléares
aniversario	anniversaire
antigua y barbudas	antigua-et-barbudas
racismo	racisme
leer	lire
lees	lits
paciente	doux
ferri  ; transbordador s	ferrys
cejas	sourcils
franja de gaza s	bande de gazas
virus s	viruss
cien ; cientos	cents
morsa s	morses
artes	arts
las muchachas	filles
contenders	lutte
cuarto s	quartiers
macroprocesadors	macroprocesseurs
saltamontes s	sauterelles
polaridadess	polaritéss
oxígeno 	oxygène
guerra	guerre
academismo	academisme
bailaríns	danceurs
suegras	droits
vivos	réalistes
programas	logiciels
cabra 	oie
argumento	dispute
